"","N_EDIFICIOS_CLASSICOS","N_EDIFICIOS_CLASS_CONST_1_OU_2_ALOJ","N_EDIFICIOS_CLASS_CONST_3_OU_MAIS_ALOJAMENTOS","N_EDIFICIOS_EXCLUSIV_RESID","N_EDIFICIOS_1_OU_2_PISOS","N_EDIFICIOS_3_OU_MAIS_PISOS","N_EDIFICIOS_CONSTR_ANTES_1945","N_EDIFICIOS_CONSTR_1946_1980","N_EDIFICIOS_CONSTR_1981_2000","N_EDIFICIOS_CONSTR_2001_2010","N_EDIFICIOS_CONSTR_2011_2021","N_EDIFICIOS_COM_NECESSIDADES_REPARACAO","N_ALOJAMENTOS_TOTAL","N_ALOJAMENTOS_FAMILIARES","N_ALOJAMENTOS_FAM_CLASS_RHABITUAL","N_ALOJAMENTOS_FAM_CLASS_VAGOS_OU_RESID_SECUNDARIA","N_RHABITUAL_ACESSIVEL_CADEIRAS_RODAS","N_RHABITUAL_COM_ESTACIONAMENTO","N_RHABITUAL_PROP_OCUP","N_RHABITUAL_ARRENDADOS","N_AGREGADOS_DOMESTICOS_PRIVADOS","N_ADP_1_OU_2_PESSOAS","N_ADP_3_OU_MAIS_PESSOAS","N_NUCLEOS_FAMILIARES","N_NUCLEOS_FAMILIARES_COM_FILHOS_TENDO_O_MAIS_NOVO_MENOS_DE_25","N_INDIVIDUOS","N_INDIVIDUOS_H","N_INDIVIDUOS_M","N_INDIVIDUOS_0_14","N_INDIVIDUOS_15_24","N_INDIVIDUOS_25_64","N_INDIVIDUOS_65_OU_MAIS","postal_code"
"1",15,1,14,12,1,14,10,4,0,1,0,4,114,114,84,30,2,4,30,45,84,52,32,39,15,202,106,96,14,31,127,30,"1170-193"
"2",10,0,9,7,0,10,9,0,0,0,1,1,93,92,63,29,21,11,18,38,63,40,23,35,22,197,75,122,26,24,85,62,"1050-180"
"3",8,8,0,8,6,2,0,4,1,3,0,0,8,8,6,2,3,4,4,2,6,1,5,5,4,21,12,9,4,5,9,3,"1400-139"
"4",8,8,0,8,8,0,0,8,0,0,0,0,8,8,7,1,3,7,6,1,7,4,3,6,3,20,8,12,4,2,7,7,"1400"
"5",8,8,0,8,8,0,0,8,0,0,0,0,8,8,7,1,2,6,6,1,7,3,4,7,5,22,9,13,7,3,8,4,"1400-139"
"6",37,15,22,35,31,6,28,5,3,0,1,19,124,124,82,42,11,15,34,36,82,55,27,51,28,178,92,86,17,24,109,28,"1950-147"
"7",28,7,21,26,6,22,16,12,0,0,0,1,134,134,98,36,5,4,32,58,98,78,20,44,23,195,82,113,23,19,114,39,"1000-243"
"8",8,8,0,8,8,0,5,0,0,2,1,1,8,8,6,2,2,5,5,0,6,4,2,4,2,12,5,7,0,3,8,1,"1070-181"
"9",3,0,3,3,0,3,0,2,1,0,0,1,27,27,20,7,6,6,13,6,20,16,4,8,2,42,17,25,2,6,22,12,"1050-180"
"10",7,2,5,7,2,5,0,6,1,0,0,0,55,55,42,13,8,2,19,19,42,32,10,21,6,87,44,43,14,8,46,19,"1070-034"
"11",8,0,8,4,0,8,1,5,1,1,0,2,78,78,59,19,5,14,36,18,59,42,17,32,15,122,55,67,15,11,70,26,"1000-093"
"12",11,2,9,10,0,11,10,1,0,0,0,3,56,56,43,13,5,6,18,24,43,29,14,26,14,101,48,53,13,12,53,23,"1050-000"
"13",0,0,0,0,0,0,0,0,0,0,0,0,0,0,0,0,0,0,0,0,0,0,0,0,0,0,0,0,0,0,0,0,"1950-408"
"14",32,3,29,28,5,27,17,11,0,4,0,15,165,165,130,35,5,7,33,91,130,99,31,66,29,276,142,134,21,36,167,52,"1900-998"
"15",25,0,23,20,0,25,6,16,1,1,1,3,268,266,162,104,24,32,65,78,163,113,50,82,31,360,157,203,30,36,202,92,"1000-024"
"16",9,0,9,7,0,9,2,7,0,0,0,4,45,45,23,22,2,6,14,8,23,17,6,12,5,51,22,29,7,5,23,16,"1050-120"
"17",1,0,1,1,0,1,1,0,0,0,0,0,14,14,12,2,0,0,8,0,12,5,7,10,6,37,18,19,7,6,18,6,NA
"18",22,3,19,22,4,18,18,4,0,0,0,3,116,116,89,27,3,0,29,52,89,66,23,37,15,180,87,93,14,15,114,37,"1000-172"
"19",10,0,10,6,0,10,0,5,5,0,0,5,352,352,292,60,118,9,229,34,292,203,89,180,74,625,277,348,65,61,314,185,"1500-110"
"20",18,0,17,13,1,17,0,18,0,0,0,5,133,132,108,24,3,5,72,25,108,73,35,59,30,229,104,125,27,34,113,55,"1700-036"
"21",25,10,15,24,8,17,7,9,9,0,0,2,215,215,168,47,31,90,131,26,168,111,57,98,43,354,165,189,42,27,187,98,"1500-592"
"22",8,0,8,7,0,8,0,8,0,0,0,8,87,87,65,22,17,47,46,12,65,41,24,40,19,151,71,80,25,12,65,49,"1449-039"
"23",9,9,0,9,8,1,0,8,1,0,0,1,9,9,7,2,1,6,7,0,7,4,3,5,3,19,7,12,4,4,5,6,"1400"
"24",39,31,8,37,26,13,38,0,0,0,1,13,73,73,38,35,9,2,8,27,38,29,9,22,12,76,39,37,10,8,36,22,"1349-022"
"25",12,10,2,12,10,2,5,6,0,1,0,3,30,30,21,9,6,5,16,3,21,17,4,11,3,38,15,23,4,1,13,20,"1400-077"
"26",15,14,1,15,11,4,5,7,2,1,0,1,20,20,19,1,8,9,14,4,19,10,9,17,6,51,25,26,6,5,30,10,"1400-077"
"27",27,27,0,27,13,14,1,25,1,0,0,3,28,28,22,6,5,18,21,1,22,10,12,17,11,70,33,37,14,13,28,15,"1449-039"
"28",0,0,0,0,0,0,0,0,0,0,0,0,0,0,0,0,0,0,0,0,0,0,0,0,0,0,0,0,0,0,0,0,NA
"29",12,0,12,12,0,12,0,12,0,0,0,8,216,216,161,55,35,1,72,77,161,126,35,93,25,312,135,177,28,17,157,110,"1500-547"
"30",4,0,4,3,0,4,0,0,4,0,0,0,111,111,86,25,37,78,65,12,86,64,22,52,22,175,73,102,17,19,69,70,"1500-611"
"31",28,13,15,28,17,11,18,10,0,0,0,26,96,96,69,27,8,0,19,44,69,48,21,40,25,154,76,78,34,17,68,35,"1250-096"
"32",14,0,13,12,0,14,0,13,1,0,0,8,200,199,154,45,26,27,106,31,154,123,31,77,27,290,136,154,25,21,127,117,"1600-161"
"33",28,0,28,28,0,28,0,28,0,0,0,2,196,196,164,32,12,13,76,66,164,101,63,98,60,376,190,186,78,40,184,74,"1700-204"
"34",6,0,6,3,0,6,0,6,0,0,0,4,97,97,77,20,14,30,42,29,77,64,13,32,12,134,62,72,13,10,61,50,"1600-154"
"35",5,0,5,4,0,5,0,0,0,5,0,0,88,88,61,27,60,61,29,28,61,31,30,50,29,163,82,81,36,14,103,10,"1950-080"
"36",10,2,8,8,1,9,0,9,0,1,0,3,55,55,33,22,9,13,19,12,33,21,12,18,10,73,31,42,9,10,33,21,"1050-047"
"37",15,3,12,14,4,11,0,15,0,0,0,8,108,108,73,35,3,2,33,36,73,51,22,36,21,150,68,82,28,10,79,33,"1200-624"
"38",1,0,1,0,0,1,1,0,0,0,0,0,4,4,4,0,0,0,0,2,4,4,0,2,0,7,2,5,0,1,6,0,"1100-054"
"39",28,9,19,26,11,17,28,0,0,0,0,12,142,142,114,28,12,2,7,104,114,90,24,64,23,223,103,120,20,19,133,51,"1300-023"
"40",13,4,9,12,4,9,1,10,2,0,0,9,119,119,92,27,23,3,63,24,92,56,36,57,29,218,92,126,32,27,100,59,"1400-191"
"41",18,1,17,10,0,18,18,0,0,0,0,5,66,66,43,23,1,1,9,30,43,32,11,15,7,83,51,32,8,7,54,14,"1200-096"
"42",6,6,0,6,6,0,4,1,1,0,0,1,6,6,5,1,3,4,4,1,5,2,3,5,2,14,8,6,3,0,7,4,"1349-016"
"43",21,3,18,13,2,19,20,1,0,0,0,16,73,73,46,27,6,0,8,37,46,38,8,16,9,81,33,48,13,7,46,15,"1100-538"
"44",10,4,6,7,1,9,8,2,0,0,0,2,54,54,21,33,5,5,6,14,21,16,5,11,5,40,25,15,5,3,25,7,"1200-036"
"45",7,0,7,5,0,7,6,1,0,0,0,2,31,31,10,21,0,0,3,5,10,8,2,3,1,17,9,8,0,3,11,3,"1200-254"
"46",11,1,10,7,0,11,11,0,0,0,0,3,50,50,27,23,0,0,20,6,27,21,6,9,3,45,19,26,0,4,22,19,"1200-115"
"47",2,1,1,2,0,2,2,0,0,0,0,1,5,5,1,4,1,0,0,1,1,0,1,1,0,3,2,1,0,0,1,2,"1100-054"
"48",29,10,19,28,3,26,19,4,1,1,4,11,107,107,63,44,8,1,13,46,63,50,13,31,9,118,49,69,7,11,69,31,"1200-780"
"49",8,0,8,6,0,8,0,7,0,1,0,1,69,69,52,17,9,3,30,16,52,32,20,34,18,130,60,70,25,16,65,24,"1070-128"
"50",9,0,9,7,0,9,1,6,2,0,0,1,117,117,81,36,29,17,21,57,81,65,16,30,14,139,72,67,13,9,84,33,"1050-025"
"51",11,0,11,6,0,11,3,5,1,1,1,1,74,74,42,32,18,17,16,18,42,29,13,25,10,102,53,49,12,9,65,16,"1000-141"
"52",16,2,13,11,1,15,0,15,0,1,0,4,104,103,63,40,10,15,41,14,65,38,27,42,24,185,98,87,35,20,71,59,"1050-047"
"53",15,0,15,10,0,15,4,6,3,1,1,5,176,176,112,64,64,67,70,27,112,77,35,63,26,243,109,134,32,23,132,56,"1000-139"
"54",30,25,5,30,25,5,23,0,6,1,0,5,80,80,73,7,9,7,61,7,73,36,37,59,25,197,98,99,31,13,96,57,"1070-181"
"55",43,30,13,43,35,8,25,15,1,1,1,31,115,115,76,39,9,2,16,57,76,41,35,52,35,201,92,109,50,18,104,29,"1070-165"
"56",38,6,32,33,1,37,5,24,1,2,6,14,321,321,257,64,51,102,143,91,257,165,92,144,69,590,285,305,78,59,334,119,"1000-172"
"57",16,6,10,13,7,9,7,9,0,0,0,10,165,165,133,32,5,4,71,53,133,108,25,87,25,260,121,139,27,13,118,102,"1900-107"
"58",9,0,9,9,0,9,0,0,1,8,0,9,137,137,114,23,39,1,9,100,114,63,51,77,45,317,149,168,55,56,150,56,"1900-269"
"59",11,0,11,11,0,11,0,11,0,0,0,0,126,126,108,18,10,1,28,71,108,70,38,75,29,243,121,122,21,23,124,75,"1900-330"
"60",41,41,0,41,41,0,0,26,0,0,15,0,41,41,39,2,30,1,1,37,39,20,19,32,18,107,51,56,13,15,53,26,"1500-534"
"61",11,0,11,7,0,11,0,11,0,0,0,0,192,192,163,29,50,64,111,32,163,119,44,91,31,324,144,180,23,35,127,139,"1500-102"
"62",15,15,0,15,15,0,1,11,3,0,0,5,15,15,10,5,4,9,8,1,10,5,5,7,4,31,11,20,5,6,15,5,"1500-481"
"63",14,0,14,13,0,14,0,12,2,0,0,6,282,282,231,51,85,61,113,103,231,164,67,134,61,493,219,274,49,55,257,132,"1700-009"
"64",6,0,6,3,0,6,0,6,0,0,0,4,123,123,98,25,22,0,34,60,98,63,35,62,33,223,98,125,34,29,92,68,"1700-195"
"65",0,0,0,0,0,0,0,0,0,0,0,0,0,0,0,0,0,0,0,0,0,0,0,0,0,0,0,0,0,0,0,0,"1500-400"
"66",22,0,22,15,0,22,0,21,0,1,0,1,358,358,271,87,97,32,107,142,271,191,80,145,78,554,244,310,79,52,297,126,"1700-178"
"67",6,0,6,6,0,6,0,0,0,6,0,0,128,128,110,18,87,110,96,10,110,48,62,99,64,311,145,166,63,38,183,27,"1500-851"
"68",27,25,0,27,17,10,0,27,0,0,0,10,28,26,23,3,10,22,19,0,24,9,15,19,13,85,30,55,9,16,36,24,"1700-194"
"69",18,0,18,18,0,18,0,0,18,0,0,18,209,209,204,5,29,1,3,178,204,93,111,175,86,588,307,281,97,66,337,88,"1950-080"
"70",14,9,5,13,2,12,0,12,2,0,0,4,93,93,72,21,3,12,14,55,72,52,20,33,19,148,57,91,21,17,80,30,"1700-108"
"71",13,0,13,11,0,13,0,13,0,0,0,2,90,90,55,35,1,1,36,12,55,37,18,36,20,129,62,67,20,15,72,22,"1700-190"
"72",5,0,4,4,0,5,0,4,1,0,0,0,104,104,92,12,39,88,83,2,92,65,27,65,22,201,92,109,28,12,67,94,"1500-065"
"73",30,0,30,28,0,30,0,9,20,1,0,24,291,291,213,78,35,48,121,79,213,166,47,108,41,410,184,226,31,35,225,119,"1500-085"
"74",9,1,8,6,1,8,0,9,0,0,0,8,156,156,122,34,37,2,96,15,122,81,41,90,37,280,127,153,17,42,124,97,"1500-851"
"75",5,0,5,3,0,5,0,4,1,0,0,0,112,112,94,18,59,91,77,6,94,67,27,59,26,201,90,111,27,17,83,74,"1500-065"
"76",5,0,5,4,0,5,0,5,0,0,0,3,100,100,88,12,47,84,76,5,88,58,30,51,21,193,90,103,19,16,88,70,"1500-506"
"77",5,0,5,5,0,5,0,5,0,0,0,3,100,100,76,24,49,72,60,9,76,50,26,51,22,177,80,97,25,18,80,54,"1500-506"
"78",9,0,9,8,0,9,0,8,1,0,0,0,181,181,147,34,66,124,103,25,147,111,36,79,29,294,131,163,35,22,122,115,"1500-506"
"79",17,0,17,16,0,17,0,17,0,0,0,3,113,113,91,22,3,2,65,13,91,56,35,62,34,210,96,114,37,20,107,46,"1700-049"
"80",16,0,16,8,0,16,0,13,1,2,0,3,197,197,144,53,23,10,104,28,144,114,30,74,30,265,106,159,34,16,112,103,"1500-107"
"81",30,2,28,20,2,28,0,24,1,5,0,12,392,392,298,94,83,86,181,102,298,206,92,178,80,640,288,352,88,55,304,193,"1500-330"
"82",10,5,4,8,6,4,0,10,0,0,0,0,74,73,58,15,2,12,33,18,66,53,13,32,8,122,48,74,7,8,54,53,"1500-225"
"83",20,0,20,17,0,20,1,14,4,1,0,15,355,355,281,74,83,98,213,48,281,208,73,164,65,575,248,327,60,57,251,207,"1500-895"
"84",32,0,32,30,0,32,0,32,0,0,0,28,249,249,190,59,9,2,77,101,190,135,55,100,48,378,173,205,43,37,209,89,"1500-085"
"85",26,0,26,21,0,26,0,23,3,0,0,24,315,315,243,72,34,73,149,73,243,191,52,133,46,474,207,267,34,44,208,188,"1500-244"
"86",18,0,18,18,0,18,0,1,17,0,0,18,286,286,258,28,85,3,104,139,258,132,126,215,109,687,327,360,104,74,401,108,"1950-151"
"87",23,13,9,22,11,12,14,8,0,0,1,1,90,89,66,23,15,15,27,37,66,36,30,42,20,199,82,117,22,21,80,76,"1700-204"
"88",77,70,7,77,69,8,61,16,0,0,0,53,112,112,56,56,16,8,28,13,56,35,21,38,20,138,65,73,30,13,63,32,"1950-132"
"89",1,0,1,0,0,1,1,0,0,0,0,0,1,1,1,0,0,0,0,1,1,1,0,0,0,2,1,1,0,0,0,2,"1100-051"
"90",8,0,8,2,0,8,8,0,0,0,0,0,54,54,34,20,3,4,23,9,34,26,8,20,9,72,32,40,8,9,40,15,"1200-996"
"91",0,0,0,0,0,0,0,0,0,0,0,0,0,0,0,0,0,0,0,0,0,0,0,0,0,0,0,0,0,0,0,0,"1400-015"
"92",14,14,0,14,14,0,1,11,1,0,1,1,14,14,13,1,3,8,11,1,13,5,8,13,9,43,19,24,7,8,22,6,"1349-016"
"93",30,9,21,22,13,17,9,16,5,0,0,11,94,94,57,37,6,4,19,36,57,43,14,30,11,131,77,54,12,11,86,22,"1150-324"
"94",0,0,0,0,0,0,0,0,0,0,0,0,0,0,0,0,0,0,0,0,0,0,0,0,0,0,0,0,0,0,0,0,"1250-044"
"95",82,44,38,75,52,30,59,22,0,0,1,57,317,317,211,106,11,23,79,125,211,151,60,121,57,439,194,245,55,34,254,96,"1350-097"
"96",7,4,3,6,1,6,4,0,0,1,2,0,39,39,17,22,8,15,12,3,17,10,7,15,7,44,19,25,7,6,20,11,"1250-042"
"97",11,3,8,9,2,9,8,2,0,0,1,2,44,44,25,19,4,3,9,13,25,22,3,11,2,49,30,19,2,1,36,10,"1150-207"
"98",0,0,0,0,0,0,0,0,0,0,0,0,0,0,0,0,0,0,0,0,0,0,0,0,0,0,0,0,0,0,0,0,"1750-184"
"99",16,0,16,14,0,16,0,0,15,1,0,16,204,204,181,23,108,8,28,147,181,84,97,144,83,519,248,271,109,68,254,88,"1600-647"
"100",8,0,8,7,0,8,0,8,0,0,0,8,105,105,83,22,21,3,48,27,83,66,17,50,14,163,77,86,10,11,62,80,"1750-160"
"101",9,0,9,9,0,9,0,3,6,0,0,0,120,120,94,26,48,53,60,22,94,64,30,55,27,193,93,100,27,14,126,26,"1600-805"
"102",0,0,0,0,0,0,0,0,0,0,0,0,0,0,0,0,0,0,0,0,0,0,0,0,0,0,0,0,0,0,0,0,"1800-178"
"103",15,0,15,13,0,15,0,15,0,0,0,4,151,151,128,23,31,4,102,11,128,87,41,70,34,266,121,145,33,25,149,59,"1800-111"
"104",30,23,7,30,26,4,28,0,2,0,0,17,70,70,55,15,3,1,26,25,55,36,19,39,14,128,65,63,18,8,74,28,"1800-048"
"105",10,0,10,6,0,10,0,10,0,0,0,10,192,192,158,34,4,7,113,36,158,115,43,91,38,317,146,171,25,34,161,97,"1800-048"
"106",0,0,0,0,0,0,0,0,0,0,0,0,0,0,0,0,0,0,0,0,0,0,0,0,0,0,0,0,0,0,0,0,"1990-057"
"107",23,0,23,22,0,23,0,0,23,0,0,12,293,293,269,24,119,6,49,214,269,183,86,193,80,622,292,330,65,54,304,199,"1600-647"
"108",0,0,0,0,0,0,0,0,0,0,0,0,0,0,0,0,0,0,0,0,0,0,0,0,0,0,0,0,0,0,0,0,"1349-016"
"109",7,2,5,2,0,7,4,0,3,0,0,0,25,25,15,10,3,2,7,5,15,12,3,10,3,30,19,11,0,5,17,8,"1200-224"
"110",10,4,6,7,2,8,8,1,0,0,1,5,22,22,16,6,0,0,5,10,16,11,5,7,3,29,20,9,2,3,20,4,"1200-154"
"111",5,0,5,4,0,5,5,0,0,0,0,1,21,21,14,7,0,0,1,13,14,13,1,4,2,22,11,11,1,1,14,6,"1200"
"112",10,1,9,6,1,9,10,0,0,0,0,3,31,31,21,10,0,0,6,15,21,18,3,8,3,34,17,17,2,3,14,15,"1200-115"
"113",27,27,0,27,25,2,7,14,2,1,3,5,27,27,19,8,3,9,18,0,19,7,12,16,7,52,29,23,5,7,24,16,"1349-016"
"114",32,24,8,30,18,14,31,1,0,0,0,26,62,62,39,23,3,3,16,21,39,29,10,21,8,81,36,45,9,11,44,17,"1250-033"
"115",16,3,13,12,3,13,11,5,0,0,0,13,59,59,45,14,0,0,19,26,45,32,13,22,12,89,42,47,8,12,48,21,"1170-379"
"116",62,11,51,57,16,46,2,38,19,3,0,30,288,288,194,94,13,19,74,108,194,137,57,108,50,413,209,204,60,32,226,95,"1170-376"
"117",21,0,21,18,0,21,7,11,3,0,0,10,132,132,96,36,8,8,38,53,96,69,27,55,27,199,95,104,28,18,99,54,"1350-166"
"118",17,0,17,16,0,17,6,10,1,0,0,7,140,140,123,17,9,7,33,79,123,91,32,79,38,267,129,138,34,30,142,61,"1350-166"
"119",15,0,15,11,1,14,10,2,0,3,0,7,87,87,55,32,9,9,29,25,55,44,11,30,11,105,47,58,8,7,58,32,"1170-337"
"120",16,1,15,14,1,15,5,10,0,0,1,2,109,109,81,28,15,1,33,45,81,60,21,49,23,172,71,101,19,19,84,50,"1350-168"
"121",6,0,6,6,0,6,3,2,0,1,0,1,51,51,34,17,2,2,12,19,34,23,11,21,9,77,33,44,7,11,42,17,"1350-145"
"122",16,1,15,15,1,15,0,15,1,0,0,0,171,171,116,55,17,15,44,61,116,93,23,52,21,213,80,133,25,13,116,59,"1350-330"
"123",7,1,6,4,3,4,5,2,0,0,0,6,42,42,23,19,0,0,6,16,23,21,2,6,1,31,15,16,1,0,19,11,"1169-056"
"124",2,2,0,2,2,0,0,2,0,0,0,2,2,2,1,1,1,0,0,0,1,0,1,1,1,3,2,1,0,1,2,0,"1400-081"
"125",13,3,10,11,3,10,3,9,1,0,0,2,115,115,90,25,22,25,48,32,90,64,26,51,26,195,90,105,25,18,100,52,"1350-273"
"126",39,13,26,27,6,33,25,10,4,0,0,20,114,114,84,30,5,4,12,64,84,35,49,44,27,296,206,90,25,36,211,24,"1100-391"
"127",29,12,17,25,8,21,13,15,1,0,0,15,88,88,44,44,5,3,18,21,44,23,21,28,11,112,57,55,9,12,73,18,"1150-199"
"128",21,7,14,19,8,13,17,1,2,1,0,9,99,99,63,36,0,15,28,31,63,42,21,38,14,135,69,66,14,10,79,32,"1170-381"
"129",31,11,20,25,11,20,18,13,0,0,0,2,149,149,107,42,4,4,42,56,107,88,19,55,15,193,83,110,14,5,113,61,"1170-112"
"130",1,1,0,1,1,0,1,0,0,0,0,1,1,1,1,0,0,1,0,0,1,1,0,0,0,1,1,0,0,0,1,0,"1100-108"
"131",25,7,18,19,8,17,21,4,0,0,0,19,171,171,134,37,3,4,37,92,134,96,38,66,29,283,140,143,35,18,174,56,"1100-085"
"132",45,10,34,36,11,34,28,13,3,1,0,32,282,281,208,73,34,40,105,85,208,115,93,146,78,562,281,281,87,82,280,113,"1250-033"
"133",16,9,7,14,8,8,16,0,0,0,0,2,45,45,34,11,1,2,6,23,34,23,11,16,8,70,35,35,11,2,38,19,"1250-039"
"134",50,20,30,49,20,30,43,6,0,0,1,1,245,245,176,69,20,9,74,87,176,142,34,86,37,322,142,180,29,29,189,75,"1250-033"
"135",68,37,31,61,47,21,60,3,3,2,0,47,228,228,171,57,18,27,56,105,171,135,36,79,30,327,145,182,31,26,187,83,"1250-033"
"136",70,13,57,49,6,64,42,21,1,0,6,10,346,346,230,116,37,42,81,131,230,174,56,118,50,461,225,236,62,44,266,89,"1250"
"137",34,6,28,25,6,28,17,9,4,1,3,19,207,207,133,74,13,22,50,71,133,90,43,69,37,296,148,148,49,25,171,51,"1250-015"
"138",32,4,28,29,3,29,18,13,0,0,1,15,135,135,103,32,8,9,51,43,103,77,26,52,21,218,108,110,26,15,123,54,"1170-378"
"139",29,13,15,28,20,9,22,4,1,1,1,13,95,94,61,33,7,1,13,42,61,42,19,37,20,164,63,101,20,17,73,54,"1350-097"
"140",82,21,60,62,23,59,80,1,1,0,0,38,359,358,237,121,25,9,27,199,237,106,131,88,50,959,791,168,60,79,772,48,"1100-085"
"141",14,0,14,14,0,14,9,4,1,0,0,3,70,70,50,20,1,1,21,26,50,35,15,30,9,102,48,54,8,3,64,27,"1170-381"
"142",10,0,10,9,0,10,3,7,0,0,0,6,102,102,83,19,2,0,28,53,83,67,16,40,19,154,62,92,17,14,74,49,"1350-166"
"143",14,2,12,11,1,13,6,8,0,0,0,0,150,150,109,41,23,24,32,64,109,90,19,46,14,195,80,115,8,22,108,57,"1050-170"
"144",6,1,5,4,0,6,0,4,0,2,0,2,71,71,35,36,13,24,18,9,35,30,5,20,4,65,28,37,5,3,31,26,"1050-019"
"145",59,59,0,59,59,0,0,57,0,1,1,33,59,59,48,11,18,32,41,4,48,29,19,35,17,115,53,62,12,20,56,27,"1900-107"
"146",0,0,0,0,0,0,0,0,0,0,0,0,0,0,0,0,0,0,0,0,0,0,0,0,0,0,0,0,0,0,0,0,"1500-536"
"147",33,1,31,32,2,31,20,13,0,0,0,3,234,234,156,78,3,0,60,80,156,129,27,63,20,286,125,161,18,29,175,64,"1900-462"
"148",30,2,28,27,3,27,3,11,0,16,0,6,408,408,336,72,211,237,226,90,336,214,122,228,124,752,355,397,124,56,441,131,"1950-449"
"149",9,0,9,7,0,9,0,2,7,0,0,9,183,183,156,27,6,3,101,51,156,108,48,96,41,330,155,175,40,23,171,96,"1950-230"
"150",2,2,0,2,2,0,0,2,0,0,0,2,4,4,2,0,0,0,0,0,4,2,2,3,1,10,3,7,3,2,5,0,"1950-157"
"151",2,1,1,2,1,1,1,1,0,0,0,2,7,7,4,3,0,1,0,3,4,2,2,4,1,10,5,5,1,0,7,2,"1350-188"
"152",51,38,13,51,40,11,40,4,5,1,1,23,109,109,67,41,5,1,26,37,68,58,10,30,7,119,54,65,7,7,70,35,"1350-188"
"153",3,0,3,1,0,3,0,3,0,0,0,0,132,132,106,26,85,98,87,12,106,74,32,70,24,227,100,127,21,22,89,95,"1500-030"
"154",8,1,7,3,0,8,8,0,0,0,0,5,49,49,22,27,8,1,8,12,22,18,4,12,3,43,21,22,5,2,31,5,"1100-042"
"155",18,2,16,8,2,16,13,3,0,1,1,5,102,102,56,46,10,9,31,22,56,37,19,37,20,135,64,71,20,20,71,24,"1100-171"
"156",9,1,8,3,1,8,4,0,0,5,0,0,41,41,29,12,5,10,15,14,29,18,11,27,12,78,43,35,9,10,47,12,"1200-115"
"157",14,14,0,14,14,0,0,14,0,0,0,1,15,15,11,4,1,2,10,1,11,8,3,8,2,24,14,10,0,2,14,8,"1349-016"
"158",2,1,0,2,0,2,2,0,0,0,0,1,2,1,1,0,0,0,1,0,1,0,1,1,1,22,21,1,1,12,8,1,"1100-416"
"159",21,8,13,19,1,20,5,7,5,4,0,7,104,104,79,25,9,25,39,35,79,52,27,45,19,176,86,90,23,16,86,51,"1200-828"
"160",13,1,12,9,0,13,13,0,0,0,0,0,51,51,42,9,3,0,10,32,42,33,9,16,9,89,48,41,8,15,47,19,"1100-172"
"161",11,3,8,6,1,10,11,0,0,0,0,11,36,36,26,10,0,0,0,22,26,23,3,13,2,50,25,25,3,4,33,10,"1100-542"
"162",29,5,24,21,2,27,29,0,0,0,0,5,104,104,61,43,1,4,19,37,61,44,17,30,18,122,54,68,20,12,74,16,"1200-321"
"163",0,0,0,0,0,0,0,0,0,0,0,0,0,0,0,0,0,0,0,0,0,0,0,0,0,0,0,0,0,0,0,0,"1100-232"
"164",20,18,2,20,17,3,2,16,1,1,0,6,29,29,21,8,3,7,14,4,21,13,8,13,6,47,22,25,6,2,24,15,"1300-070"
"165",15,0,15,12,0,15,6,8,0,0,1,1,119,119,94,25,14,12,47,39,94,66,28,50,27,195,90,105,32,19,104,40,"1350-180"
"166",35,15,20,33,19,16,35,0,0,0,0,19,117,117,75,42,3,1,16,55,75,53,22,39,14,153,65,88,15,7,96,35,"1170-381"
"167",39,11,27,26,8,31,10,25,4,0,0,13,141,141,88,53,7,5,35,50,88,66,22,42,13,177,88,89,13,8,108,48,"1150-251"
"168",0,0,0,0,0,0,0,0,0,0,0,0,0,0,0,0,0,0,0,0,0,0,0,0,0,0,0,0,0,0,0,0,"1170-041"
"169",57,37,19,55,38,19,44,7,1,2,3,18,154,154,117,37,21,22,35,72,117,82,35,53,35,240,113,127,38,28,135,39,"1250-250"
"170",36,8,28,32,15,21,25,10,1,0,0,12,165,165,123,42,4,4,46,67,123,104,19,54,19,218,109,109,15,26,132,45,"1170-339"
"171",71,47,23,68,53,18,63,1,0,7,0,27,165,164,90,74,12,13,46,42,90,64,26,51,23,203,110,93,22,30,117,34,"1170-381"
"172",51,44,7,51,48,3,40,11,0,0,0,43,83,83,59,24,9,0,2,53,59,42,17,29,19,119,55,64,16,20,59,24,"1070-181"
"173",9,0,9,8,0,9,1,7,0,1,0,1,81,81,60,21,22,10,32,24,60,35,25,37,17,139,63,76,22,12,68,37,"1050-000"
"174",16,1,15,14,1,15,5,11,0,0,0,1,152,152,104,48,22,0,64,29,104,74,30,61,29,224,99,125,21,25,135,43,"1000-060"
"175",8,0,8,7,0,8,0,0,8,0,0,7,217,217,201,16,113,5,7,189,201,113,88,174,95,591,276,315,105,78,291,117,"1500-536"
"176",26,4,22,24,6,20,21,4,1,0,0,7,158,158,114,44,31,33,40,65,114,81,33,56,24,244,115,129,29,29,144,42,"1000-243"
"177",1,1,0,1,1,0,0,0,0,1,0,0,1,1,0,1,0,0,0,0,0,0,0,0,0,0,0,0,0,0,0,0,"1500-524"
"178",15,0,15,15,0,15,0,0,15,0,0,0,210,210,192,18,45,3,30,159,192,77,115,186,110,610,277,333,103,88,313,106,"1500-536"
"179",15,1,14,12,0,15,7,8,0,0,0,11,108,108,55,53,2,1,18,31,55,41,14,23,12,114,48,66,12,14,71,17,"1150-016"
"180",9,1,8,8,1,8,5,1,1,2,0,3,42,42,32,10,5,4,9,20,32,22,10,16,7,76,39,37,8,8,42,18,"1000-040"
"181",39,28,11,39,32,7,28,6,0,2,3,3,123,123,94,29,6,2,44,42,94,68,26,51,22,187,88,99,17,16,103,51,"1900-311"
"182",10,0,10,8,0,10,6,2,0,1,1,1,93,93,49,44,18,26,28,16,49,32,17,30,17,111,59,52,25,5,61,20,"1069-146"
"183",4,0,4,4,0,4,0,0,0,4,0,0,84,84,57,27,55,57,39,13,57,41,16,34,16,124,68,56,29,3,61,31,NA
"184",30,2,28,25,3,27,9,19,1,1,0,6,220,220,161,59,5,17,65,86,161,107,54,84,44,354,179,175,39,30,215,70,"1000-046"
"185",19,3,16,18,1,18,12,5,2,0,0,6,151,151,103,48,7,3,46,50,103,79,24,47,16,206,92,114,14,22,118,52,"1000-047"
"186",7,6,1,7,7,0,7,0,0,0,0,6,10,10,6,4,4,0,0,5,6,4,2,4,2,13,4,9,3,3,3,4,"1900-107"
"187",4,1,3,4,2,2,2,2,0,0,0,2,18,18,9,9,0,0,1,8,9,6,3,6,2,20,13,7,2,3,9,6,"1900-278"
"188",4,0,4,3,0,4,1,3,0,0,0,1,35,35,23,12,2,0,2,19,23,13,10,17,10,61,31,30,8,12,33,8,"1050-251"
"189",16,8,8,16,11,5,14,1,0,1,0,6,53,53,40,13,1,1,16,24,40,28,12,22,13,85,38,47,11,10,48,16,"1900-278"
"190",37,37,0,37,32,5,0,25,12,0,0,7,37,37,33,4,11,18,31,1,33,18,15,25,11,81,35,46,9,7,39,26,"1500-303"
"191",9,0,9,9,0,9,0,9,0,0,0,9,145,145,111,34,54,12,67,25,111,70,41,70,39,260,118,142,35,34,131,60,"1700-173"
"192",17,0,17,12,0,17,0,16,0,1,0,2,395,395,339,56,146,188,268,37,339,240,99,218,89,732,319,413,89,71,304,268,"1500"
"193",6,1,5,6,1,5,0,6,0,0,0,2,52,52,31,21,4,2,17,12,31,22,9,18,6,63,25,38,6,6,30,21,"1950-266"
"194",25,2,19,19,1,24,10,15,0,0,0,17,188,184,152,32,3,13,71,66,153,93,60,97,54,429,173,256,55,51,180,143,"1700-159"
"195",13,10,2,13,7,6,7,3,2,0,1,7,62,61,30,31,8,12,11,15,30,21,9,11,9,78,37,41,9,22,40,7,"1549-004"
"196",16,0,16,9,0,16,0,16,0,0,0,6,285,285,216,69,74,4,162,37,216,128,88,142,83,533,247,286,86,68,236,143,"1700"
"197",44,1,43,35,0,44,1,38,1,4,0,3,513,513,376,137,65,111,190,149,376,270,106,211,102,770,347,423,104,58,429,179,"1500-040"
"198",21,21,0,21,19,2,0,11,10,0,0,2,21,21,18,3,3,14,15,3,18,4,14,16,10,62,31,31,5,11,35,11,"1500-310"
"199",48,3,43,39,3,45,0,48,0,0,0,2,509,507,418,89,67,87,169,214,418,285,133,237,122,920,401,519,152,75,486,207,"1700-342"
"200",25,0,25,13,0,25,0,24,0,1,0,0,474,474,388,86,79,34,93,265,388,288,100,185,82,763,335,428,66,84,413,200,"1700-348"
"201",12,8,4,12,8,4,0,8,0,4,0,7,120,120,101,19,95,97,75,22,101,56,45,67,47,234,113,121,48,22,151,13,"1950-266"
"202",36,30,6,35,28,8,0,30,6,0,0,5,100,100,77,23,10,24,38,30,77,62,15,32,13,151,67,84,14,18,80,39,"1500-310"
"203",29,2,27,24,2,27,1,1,1,26,0,2,433,433,359,74,338,356,273,69,359,163,196,289,188,1022,507,515,198,159,541,124,"1500-473"
"204",27,27,0,27,27,0,0,27,0,0,0,7,27,27,22,5,3,9,21,0,22,9,13,21,12,65,27,38,14,6,34,11,"1500-599"
"205",3,0,3,2,0,3,0,0,0,3,0,0,175,175,143,32,133,140,96,36,143,86,57,88,58,339,157,182,69,31,226,13,"1950-442"
"206",22,22,0,22,22,0,0,22,0,0,0,2,22,22,17,5,7,12,15,1,17,10,7,15,6,48,24,24,8,6,21,13,"1500-310"
"207",23,2,21,21,3,20,4,7,10,2,0,7,310,310,234,76,91,137,167,42,234,160,74,142,62,502,231,271,49,54,253,146,"1600-160"
"208",21,21,0,21,21,0,0,20,1,0,0,2,21,21,21,0,6,1,15,4,21,12,9,13,6,52,25,27,5,4,30,13,"1950-299"
"209",24,24,0,24,24,0,0,24,0,0,0,7,24,24,17,7,8,10,16,1,17,7,10,16,10,59,27,32,15,8,23,13,"1500-599"
"210",19,0,19,17,0,19,0,17,2,0,0,0,302,302,250,52,49,86,175,58,250,171,79,157,66,517,224,293,65,32,254,166,"1950-449"
"211",29,0,27,24,0,29,4,24,1,0,0,7,254,253,190,63,11,10,64,100,191,146,45,97,41,388,193,195,38,36,221,93,"1000-046"
"212",28,1,27,25,0,28,0,18,10,0,0,3,180,180,132,48,9,16,63,61,132,88,44,61,27,300,148,152,24,37,176,63,"1000-098"
"213",0,0,0,0,0,0,0,0,0,0,0,0,0,0,0,0,0,0,0,0,0,0,0,0,0,0,0,0,0,0,0,0,"1069-452"
"214",19,1,18,15,1,18,1,12,0,6,0,3,119,119,88,31,13,10,37,43,88,61,27,49,30,189,95,94,24,28,110,27,"1050-082"
"215",53,6,47,50,7,46,38,11,2,1,1,34,260,260,180,80,9,3,64,102,180,138,42,101,39,360,156,204,47,27,204,82,"1900-462"
"216",8,8,0,8,8,0,0,3,0,0,5,0,8,8,8,0,5,1,0,8,8,2,6,8,4,25,13,12,0,6,16,3,"1500-524"
"217",24,4,19,20,4,20,1,17,4,2,0,11,125,124,96,28,3,2,40,48,96,63,33,51,26,219,95,124,27,20,123,49,"1000-098"
"218",30,3,27,26,5,25,19,9,2,0,0,19,143,143,107,36,3,2,29,71,107,85,22,55,22,224,100,124,23,17,144,40,"1900-458"
"219",3,0,3,2,0,3,0,1,0,2,0,1,46,46,24,22,16,17,13,10,24,17,7,16,6,55,26,29,4,10,31,10,"1050-180"
"220",6,0,6,3,0,6,0,6,0,0,0,1,66,66,51,15,3,11,29,17,51,28,23,33,20,130,63,67,18,22,63,27,"1050-228"
"221",43,4,38,36,8,35,19,20,3,1,0,4,307,306,230,76,11,5,104,107,231,158,73,118,56,488,228,260,46,67,280,95,"1900-024"
"222",11,0,11,7,0,11,0,11,0,0,0,0,163,163,137,26,15,12,83,41,137,100,37,84,32,283,125,158,30,22,132,99,"1500-004"
"223",27,0,27,25,0,27,0,25,2,0,0,21,575,575,463,112,105,102,279,145,463,364,99,259,86,901,393,508,90,57,411,343,"1500-337"
"224",15,0,15,11,0,15,0,15,0,0,0,2,190,190,138,52,21,51,104,25,138,86,52,97,41,326,163,163,50,23,175,78,"1700-010"
"225",15,15,0,15,2,13,0,15,0,0,0,0,16,16,14,2,5,14,11,1,14,6,8,14,7,51,26,25,12,10,19,10,"1700-194"
"226",18,0,18,15,0,18,2,15,1,0,0,2,167,167,129,38,14,16,70,55,129,99,30,72,34,252,99,153,27,19,142,64,"1500-004"
"227",4,0,4,4,0,4,0,0,0,4,0,0,91,91,74,17,69,74,66,6,74,46,28,45,30,174,77,97,35,17,109,13,"1500-359"
"228",23,8,14,20,4,19,9,13,0,0,1,10,105,105,76,29,3,1,28,47,76,55,21,44,20,161,65,96,16,23,90,32,"1500-108"
"229",20,0,20,19,0,20,0,20,0,0,0,2,133,133,98,35,3,0,67,18,98,68,30,50,26,197,87,110,30,16,111,40,"1700-012"
"230",16,0,16,14,0,16,2,14,0,0,0,9,196,196,163,33,13,11,73,78,163,110,53,95,46,341,135,206,37,43,153,108,"1500-357"
"231",41,23,18,37,26,15,11,25,4,1,0,7,197,197,159,38,19,55,90,59,159,114,45,95,34,325,139,186,33,21,158,113,"1500-107"
"232",11,2,8,10,1,10,4,7,0,0,0,4,74,74,54,20,1,0,11,39,54,45,9,25,8,100,46,54,12,1,50,37,"1500-267"
"233",25,5,20,15,4,21,25,0,0,0,0,20,92,92,57,35,1,0,6,47,57,53,4,31,6,96,40,56,5,7,50,34,"1100-487"
"234",14,2,12,8,2,12,14,0,0,0,0,2,56,56,34,22,3,0,8,24,34,25,9,15,9,72,35,37,6,11,40,15,"1100-287"
"235",13,4,9,12,3,10,3,7,2,1,0,9,152,152,115,37,23,3,16,91,115,53,62,85,54,308,142,166,78,31,149,50,"1300-253"
"236",3,0,3,1,0,3,1,0,0,2,0,3,13,13,10,3,1,0,2,7,10,7,3,8,2,24,15,9,1,2,19,2,"1100-232"
"237",38,38,0,38,38,0,0,38,0,0,0,0,38,38,11,27,0,0,0,11,11,7,4,4,3,22,7,15,4,0,7,11,"1349-016"
"238",6,0,6,6,0,6,0,2,0,3,1,0,186,186,120,66,82,107,89,23,120,64,56,92,55,315,150,165,55,38,168,54,"1400-081"
"239",41,2,38,30,2,39,40,1,0,0,0,13,174,173,104,69,4,4,29,71,104,77,27,58,22,271,162,109,25,17,191,38,"1200-321"
"240",21,6,15,21,4,17,10,10,1,0,0,11,93,93,64,29,16,9,21,36,64,41,23,36,20,152,71,81,29,18,78,27,"1200-622"
"241",13,2,11,10,5,8,13,0,0,0,0,9,52,52,42,10,2,0,9,28,42,36,6,15,6,66,31,35,3,3,38,22,NA
"242",3,1,2,1,0,3,3,0,0,0,0,0,12,12,6,6,1,3,3,3,6,5,1,4,1,13,8,5,1,1,7,4,"1200-301"
"243",22,13,9,22,16,6,22,0,0,0,0,9,53,53,32,21,8,10,7,24,32,23,9,24,9,72,35,37,6,11,35,20,"1300-340"
"244",8,8,0,8,8,0,0,8,0,0,0,1,8,8,7,1,4,6,7,0,7,4,3,5,2,17,8,9,0,4,11,2,"1400-140"
"245",14,8,6,12,2,12,11,0,0,3,0,6,33,33,29,4,6,10,10,17,29,17,12,21,14,82,31,51,22,10,43,7,"1300-340"
"246",23,22,1,23,4,19,0,22,1,0,0,2,25,25,19,6,6,16,15,4,19,9,10,16,8,63,33,30,6,18,28,11,"1400-021"
"247",9,3,6,7,3,6,3,6,0,0,0,1,43,43,32,11,5,15,18,10,32,23,9,17,10,70,31,39,14,8,24,24,"1200-786"
"248",8,0,8,6,0,8,0,0,0,8,0,8,164,164,140,24,133,140,101,29,140,82,58,88,59,331,159,172,67,40,190,34,"1300-610"
"249",1,0,1,1,0,1,1,0,0,0,0,1,7,7,2,5,0,0,0,2,2,1,1,2,0,5,2,3,0,0,5,0,"1300-610"
"250",0,0,0,0,0,0,0,0,0,0,0,0,0,0,0,0,0,0,0,0,0,0,0,0,0,0,0,0,0,0,0,0,"1399-036"
"251",13,5,8,11,2,11,3,7,3,0,0,1,37,37,21,16,2,2,8,11,21,17,4,5,3,33,14,19,4,2,17,10,"1200-742"
"252",0,0,0,0,0,0,0,0,0,0,0,0,0,0,0,0,0,0,0,0,0,0,0,0,0,0,0,0,0,0,0,0,"1200-479"
"253",24,20,4,23,20,4,0,0,24,0,0,10,55,55,42,13,13,16,34,7,42,27,15,20,9,89,36,53,16,4,39,30,"1400-293"
"254",4,0,4,4,0,4,0,4,0,0,0,0,50,50,44,6,16,0,19,19,44,34,10,25,12,90,41,49,13,8,37,32,"1400-191"
"255",21,13,8,20,12,9,11,6,1,1,2,5,57,57,41,16,4,7,21,17,41,35,6,16,6,73,30,43,7,7,41,18,"1350-027"
"256",11,1,10,11,3,8,6,5,0,0,0,7,84,84,64,20,3,1,35,26,64,43,21,33,21,136,65,71,21,14,71,30,"1350-353"
"257",7,0,7,7,0,7,7,0,0,0,0,5,31,31,25,6,1,1,18,6,25,13,12,15,10,70,41,29,10,10,43,7,"1300-611"
"258",4,0,4,3,1,3,2,0,0,2,0,1,17,17,11,6,4,6,9,1,11,6,5,6,3,25,11,14,4,2,14,5,"1200-690"
"259",14,7,7,14,7,7,6,3,0,2,3,8,60,60,48,12,5,3,20,23,48,32,16,29,16,108,48,60,17,12,60,19,"1300-325"
"260",21,3,18,19,4,17,10,11,0,0,0,5,128,128,97,31,8,3,25,63,97,73,24,51,21,198,94,104,24,17,115,42,"1200-745"
"261",16,0,16,15,0,16,9,5,1,0,1,0,135,135,117,18,3,5,43,67,117,89,28,65,27,232,107,125,28,21,112,71,"1300-375"
"262",31,30,1,31,2,29,1,28,0,2,0,0,33,33,28,5,9,27,23,2,28,10,18,28,16,95,40,55,14,20,41,20,"1400-315"
"263",11,0,11,8,0,11,0,11,0,0,0,11,139,139,107,32,9,1,61,36,107,86,21,61,18,202,89,113,15,9,90,88,"1300-481"
"264",13,11,2,13,11,2,6,6,1,0,0,5,21,21,11,10,0,0,3,5,11,8,3,6,3,24,11,13,3,3,14,4,"1400-191"
"265",19,10,9,16,9,10,12,4,0,2,1,5,43,43,23,20,3,0,6,15,23,17,6,14,6,48,24,24,6,6,31,5,"1300-008"
"266",18,6,12,14,5,13,10,8,0,0,0,15,81,81,43,38,1,2,27,11,43,25,18,30,18,104,43,61,14,12,60,18,"1249-017"
"267",18,12,6,18,14,4,13,3,0,2,0,8,39,39,30,9,3,2,18,10,30,20,10,19,9,67,30,37,9,8,40,10,"1300-996"
"268",8,5,3,8,7,1,7,0,1,0,0,3,16,16,9,7,0,1,5,4,9,8,1,4,1,15,7,8,2,0,9,4,"1300-996"
"269",10,7,3,8,4,6,9,0,1,0,0,7,20,20,12,8,1,1,5,4,12,11,1,5,1,18,9,9,1,0,12,5,"1249-017"
"270",13,12,1,13,11,2,11,0,0,2,0,8,18,18,13,5,2,0,3,8,13,9,4,8,2,27,12,15,2,2,17,6,"1300-996"
"271",9,0,9,6,0,9,0,9,0,0,0,2,78,78,69,9,8,0,26,40,69,51,18,45,18,149,63,86,22,14,76,37,"1300-375"
"272",16,15,1,16,0,16,0,12,3,1,0,6,19,19,9,10,5,9,9,0,9,4,5,10,2,27,13,14,1,2,11,13,"1400-293"
"273",22,22,0,22,3,19,0,20,0,2,0,3,22,22,14,8,6,13,14,0,14,8,6,11,7,45,20,25,14,5,16,10,"1400-293"
"274",5,0,5,5,0,5,0,5,0,0,0,1,40,40,32,8,1,0,6,24,32,22,10,15,8,63,30,33,9,3,42,9,"1300-375"
"275",53,5,48,48,6,47,19,9,18,7,0,6,388,388,324,64,165,191,198,98,324,188,136,222,136,800,372,428,147,97,407,149,"1300-375"
"276",11,2,9,10,0,11,1,10,0,0,0,4,82,82,51,31,1,1,13,36,51,40,11,25,11,93,41,52,11,4,50,28,"1400-077"
"277",2,1,1,2,2,0,2,0,0,0,0,1,7,7,6,1,2,1,2,0,6,6,0,2,0,8,5,3,0,0,5,3,"1349-040"
"278",11,0,11,9,0,11,6,3,2,0,0,5,115,115,91,24,8,8,31,57,91,72,19,49,15,171,69,102,13,11,84,63,"1300-551"
"279",77,7,70,69,5,72,51,24,2,0,0,14,510,510,379,131,30,36,159,191,379,273,106,209,99,808,384,424,82,80,511,135,"1170-122"
"280",24,23,1,24,22,2,0,22,0,2,0,16,28,28,18,10,6,0,10,8,18,11,7,10,4,38,18,20,6,4,15,13,"1070-221"
"281",5,0,5,3,0,5,1,0,4,0,0,1,65,65,55,10,45,47,24,21,55,36,19,38,19,133,59,74,24,19,60,30,"1250-251"
"282",16,0,16,15,0,16,12,4,0,0,0,3,112,112,95,17,2,0,29,60,95,65,30,54,24,205,92,113,22,19,130,34,"1170-185"
"283",34,3,30,29,0,34,24,9,0,0,1,7,240,239,184,54,48,34,56,115,185,125,60,95,52,411,196,215,64,30,237,80,"1199-011"
"284",37,6,29,33,7,30,24,10,2,1,0,11,291,290,207,83,27,50,88,102,207,144,63,114,51,464,192,272,39,45,237,143,"1070-026"
"285",10,1,9,6,0,10,2,7,1,0,0,0,67,67,42,25,1,2,19,22,42,29,13,25,12,94,44,50,11,9,63,11,"1150-105"
"286",24,0,23,13,1,23,19,5,0,0,0,1,153,152,106,46,7,9,47,50,106,75,31,53,18,235,121,114,24,18,143,50,"1150-159"
"287",13,5,8,13,3,10,0,13,0,0,0,6,66,66,50,16,2,2,12,35,50,39,11,17,9,88,39,49,9,6,57,16,"1070-176"
"288",13,2,11,10,1,12,3,8,1,0,1,5,114,114,78,36,13,12,24,48,78,59,19,39,13,160,72,88,11,17,111,21,"1150-213"
"289",1,0,1,1,0,1,1,0,0,0,0,1,5,5,2,3,1,0,0,2,2,0,2,3,3,22,16,6,1,2,14,5,"1070-037"
"290",7,1,6,4,1,6,2,5,0,0,0,1,46,46,32,14,8,7,10,19,32,22,10,22,9,76,38,38,17,4,39,16,"1070-292"
"291",11,0,11,11,0,11,0,11,0,0,0,4,98,98,73,25,2,0,16,55,73,55,18,40,13,142,65,77,12,7,91,32,"1900-104"
"292",17,0,17,15,0,17,11,6,0,0,0,0,165,165,123,42,10,10,35,83,123,80,43,65,32,284,137,147,33,29,165,57,"1150-101"
"293",21,0,21,19,0,21,17,4,0,0,0,1,174,174,140,34,17,2,41,90,140,108,32,68,27,291,146,145,29,25,179,58,"1170-163"
"294",8,0,8,6,0,8,4,4,0,0,0,0,49,49,39,10,8,2,21,15,39,24,15,21,6,96,52,44,8,14,57,17,"1150-020"
"295",34,4,30,22,9,25,5,27,2,0,0,9,335,335,246,89,47,20,111,120,246,171,75,156,71,527,233,294,69,38,275,145,"1900-048"
"296",9,1,8,9,1,8,5,2,0,2,0,1,62,62,41,21,7,9,13,25,41,26,15,20,10,96,43,53,17,11,52,16,"1150-054"
"297",11,1,10,11,3,8,5,6,0,0,0,2,226,226,161,63,89,1,49,106,163,106,57,104,49,361,163,198,39,37,191,94,"1170-009"
"298",16,0,16,15,0,16,0,16,0,0,0,2,255,255,213,42,126,5,52,155,213,138,75,153,50,494,224,270,38,57,216,183,"1170-139"
"299",5,1,4,2,0,5,2,3,0,0,0,1,38,38,28,10,5,0,7,20,28,22,6,8,3,49,23,26,5,3,36,5,"1050-096"
"300",15,1,12,9,0,15,6,9,0,0,0,12,142,140,111,29,28,4,91,13,111,54,57,81,45,339,144,195,39,45,144,111,"1070-051"
"301",15,2,13,11,0,15,7,4,0,0,4,0,167,167,92,75,36,41,34,51,92,77,15,43,15,169,94,75,14,9,106,40,"1050-092"
"302",55,53,1,55,54,1,0,44,3,5,3,7,63,62,58,4,21,48,51,3,58,31,27,46,25,168,79,89,31,16,77,44,"1070-079"
"303",20,0,20,16,0,20,11,9,0,0,0,1,154,154,117,37,4,4,50,58,117,83,34,57,20,246,121,125,22,19,155,50,"1170-397"
"304",24,1,20,22,0,24,5,19,0,0,0,3,207,204,155,49,9,11,64,78,159,100,59,100,48,407,213,194,43,35,254,75,"1150-019"
"305",12,12,0,12,12,0,4,6,1,1,0,0,13,13,13,0,5,10,11,1,13,7,6,8,6,30,16,14,5,6,16,3,"1070-079"
"306",5,0,5,4,0,5,0,4,1,0,0,1,105,105,81,24,0,0,37,34,81,70,11,34,8,141,54,87,8,6,89,38,"1070"
"307",9,1,7,6,0,9,6,3,0,0,0,2,46,45,28,17,1,0,9,17,28,24,4,12,2,106,58,48,1,3,52,50,"1050-085"
"308",0,0,0,0,0,0,0,0,0,0,0,0,0,0,0,0,0,0,0,0,0,0,0,0,0,0,0,0,0,0,0,0,"1069-310"
"309",3,1,2,1,0,3,1,2,0,0,0,0,18,18,14,4,3,1,0,13,14,13,1,5,1,20,11,9,0,1,15,4,"1200-149"
"310",0,0,0,0,0,0,0,0,0,0,0,0,0,0,0,0,0,0,0,0,0,0,0,0,0,0,0,0,0,0,0,0,"1200-376"
"311",11,10,1,11,7,4,1,9,0,1,0,3,13,13,9,4,4,3,9,0,9,5,4,8,3,24,11,13,1,4,9,10,"1349-016"
"312",24,9,15,24,12,12,16,5,0,2,1,15,103,103,69,34,3,0,29,36,69,48,21,49,13,149,67,82,14,9,68,58,"1300-118"
"313",8,3,5,7,0,8,6,2,0,0,0,1,25,25,8,17,0,0,1,7,8,8,0,3,1,11,7,4,0,1,4,6,"1200-284"
"314",45,17,28,45,14,31,15,27,2,0,1,10,224,224,160,64,7,3,58,96,160,128,32,80,29,295,121,174,29,14,159,93,"1300-104"
"315",22,9,13,21,10,12,6,7,0,1,8,10,83,83,40,43,23,25,27,10,40,28,12,21,13,88,43,45,23,6,49,10,"1300-006"
"316",16,8,8,16,8,8,6,8,1,0,1,3,68,68,45,23,4,1,10,33,45,38,7,19,7,76,32,44,9,5,35,27,"1300-104"
"317",61,36,24,60,41,20,4,48,5,0,4,22,238,237,175,62,42,68,96,66,175,128,47,90,46,375,182,193,37,40,197,101,"1300-481"
"318",36,29,7,35,27,9,26,4,1,1,4,13,84,84,69,15,7,7,34,30,69,50,19,34,16,134,58,76,20,7,78,29,"1400-077"
"319",27,10,17,26,6,21,19,5,2,1,0,11,98,98,61,37,7,11,18,42,61,47,14,37,10,120,56,64,7,11,66,36,"1300-481"
"320",44,24,20,43,21,23,23,14,0,6,1,1,155,155,102,53,9,6,47,49,102,82,20,53,23,187,77,110,20,11,100,56,"1300-375"
"321",24,12,12,23,10,14,1,18,0,4,1,7,118,118,93,25,40,40,64,24,93,63,30,58,26,199,99,100,19,22,101,57,"1400-077"
"322",2,2,0,2,2,0,0,0,0,2,0,0,4,4,2,0,0,0,2,0,4,4,0,1,0,5,4,1,0,0,4,1,"1399-049"
"323",6,1,5,6,1,5,4,2,0,0,0,4,33,33,25,8,0,0,8,15,25,22,3,8,2,36,13,23,1,4,16,15,"1300-481"
"324",22,8,14,19,8,14,3,15,3,1,0,8,132,132,91,41,4,10,26,57,91,71,20,47,17,165,78,87,13,11,77,64,"1400-212"
"325",12,12,0,12,12,0,8,3,1,0,0,2,12,12,9,3,6,6,7,0,9,5,4,8,4,22,13,9,4,2,8,8,"1400-077"
"326",26,4,22,19,6,20,14,12,0,0,0,13,182,182,129,53,23,24,50,73,129,97,32,67,27,256,118,138,25,21,157,53,"1300-001"
"327",21,4,17,20,4,17,6,12,1,0,2,3,125,125,99,26,6,7,40,53,99,86,13,45,15,167,65,102,12,6,91,58,"1300-402"
"328",8,8,0,8,8,0,1,7,0,0,0,0,8,8,7,1,2,5,4,2,7,2,5,6,5,24,11,13,5,7,9,3,"1400"
"329",18,18,0,18,18,0,6,12,0,0,0,3,19,19,13,6,0,4,10,1,13,9,4,6,3,26,11,15,4,1,11,10,"1400-210"
"330",1,1,0,1,1,0,1,0,0,0,0,1,1,1,1,0,1,1,0,0,1,1,0,0,0,1,1,0,0,0,0,1,"1449-039"
"331",17,0,17,8,0,17,4,5,0,7,1,6,100,100,76,24,21,26,35,32,76,44,32,53,33,185,88,97,44,17,96,28,"1400-146"
"332",10,10,0,10,10,0,0,9,0,1,0,1,10,10,10,0,3,8,8,1,10,3,7,9,7,37,18,19,9,8,15,5,"1400-113"
"333",10,10,0,10,7,3,0,9,1,0,0,2,10,10,9,1,1,4,8,1,9,6,3,8,3,24,10,14,2,5,9,8,"1400-139"
"334",24,23,1,24,13,11,0,18,1,5,0,14,27,27,21,6,8,11,16,1,21,10,11,19,10,67,33,34,16,10,28,13,"1400-139"
"335",17,1,16,16,1,16,11,5,0,1,0,15,115,115,81,34,4,15,37,39,81,60,21,44,21,165,82,83,16,18,96,35,"1300-095"
"336",10,10,0,10,9,1,0,10,0,0,0,3,10,10,7,3,3,4,6,0,7,5,2,5,1,16,7,9,2,1,5,8,"1400-128"
"337",5,1,4,4,1,4,1,2,0,0,2,0,24,24,19,5,6,12,9,10,19,5,14,17,14,60,32,28,19,7,30,4,"1300-342"
"338",29,29,0,29,23,6,4,20,3,1,1,2,29,29,24,5,7,10,22,0,24,14,10,12,9,55,26,29,7,7,24,17,"1400-210"
"339",18,15,3,17,7,11,5,12,0,1,0,3,23,23,15,8,3,14,12,0,15,6,9,12,9,47,26,21,7,12,19,9,"1400-085"
"340",11,11,0,11,6,5,0,11,0,0,0,1,12,12,10,2,4,5,9,0,10,6,4,8,3,26,12,14,3,3,12,8,"1400-139"
"341",10,10,0,10,6,4,0,10,0,0,0,7,10,10,6,4,1,3,6,0,6,2,4,4,4,19,11,8,4,5,8,2,"1400-128"
"342",20,20,0,20,16,4,0,20,0,0,0,1,23,23,20,3,12,16,18,0,20,7,13,15,11,63,31,32,10,13,32,8,"1449-039"
"343",13,4,9,13,4,9,13,0,0,0,0,7,46,46,39,7,6,2,20,18,39,26,13,26,15,86,34,52,18,4,42,22,"1300-006"
"344",0,0,0,0,0,0,0,0,0,0,0,0,0,0,0,0,0,0,0,0,0,0,0,0,0,0,0,0,0,0,0,0,"1300-343"
"345",9,5,0,9,2,7,3,5,1,0,0,0,9,5,4,1,1,4,4,0,4,2,2,4,2,58,36,22,4,2,32,20,"1400-126"
"346",29,0,29,25,0,29,4,25,0,0,0,21,182,182,133,49,5,0,56,67,133,104,29,70,33,258,115,143,36,15,174,33,"1300-096"
"347",18,0,18,17,0,18,0,16,0,2,0,9,144,144,100,44,19,22,42,48,100,75,25,51,25,203,82,121,35,15,96,57,"1400-122"
"348",10,10,0,10,7,3,0,9,0,1,0,7,10,10,10,0,4,7,10,0,10,3,7,9,5,35,20,15,6,7,18,4,"1400-128"
"349",11,10,0,11,3,8,1,5,3,2,0,0,12,11,9,2,5,8,8,0,9,5,4,6,4,45,25,20,5,2,14,24,"1400-239"
"350",19,0,19,18,0,19,11,8,0,0,0,13,119,119,99,20,2,0,45,46,99,71,28,57,20,201,91,110,16,18,121,46,"1300-096"
"351",7,0,7,5,0,7,2,2,0,3,0,3,53,53,41,12,24,19,12,29,41,29,12,19,11,90,37,53,19,13,40,18,"1300-342"
"352",7,0,7,7,0,7,0,0,4,3,0,0,136,136,111,25,70,111,81,25,111,72,39,72,36,246,117,129,35,24,146,41,"1600-067"
"353",13,6,7,12,7,6,6,0,3,3,1,1,43,43,35,8,6,27,29,3,35,15,20,28,18,93,38,55,17,11,51,14,"1800-288"
"354",11,0,10,10,0,11,0,10,1,0,0,5,100,99,89,10,2,3,60,21,89,67,22,49,15,192,96,96,13,16,92,71,"1800-048"
"355",47,47,0,47,27,20,1,9,36,0,1,3,48,48,42,6,14,32,40,0,42,23,19,28,17,104,53,51,15,15,43,31,"1800-192"
"356",6,0,6,5,0,6,0,0,3,3,0,0,112,112,103,9,58,101,91,9,103,53,50,76,45,265,122,143,39,40,159,27,"1600-489"
"357",2,1,0,2,2,0,0,0,2,0,0,0,2,1,1,0,0,0,0,0,1,0,1,1,1,12,8,4,4,0,8,0,"1600-776"
"358",14,5,9,14,8,6,0,14,0,0,0,7,54,54,44,10,2,15,9,35,44,26,18,35,18,102,50,52,15,10,56,21,"1800-364"
"359",0,0,0,0,0,0,0,0,0,0,0,0,0,0,0,0,0,0,0,0,0,0,0,0,0,0,0,0,0,0,0,0,"1800-364"
"360",97,97,0,97,97,0,6,82,9,0,0,91,97,97,47,50,10,3,0,45,47,26,21,30,20,125,71,54,31,14,60,20,"1500-171"
"361",2,0,2,2,0,2,0,0,0,0,2,0,48,48,40,8,35,1,0,40,40,16,24,32,22,109,52,57,11,24,59,15,"1600-647"
"362",23,3,20,20,2,21,11,7,1,2,2,5,144,144,106,38,17,4,38,57,106,80,26,42,13,204,100,104,11,24,119,50,"1150-000"
"363",34,2,31,22,1,33,25,6,2,0,1,0,238,237,172,64,20,23,77,79,174,117,57,89,39,421,218,203,52,52,272,45,"1150-087"
"364",6,3,3,6,3,3,5,1,0,0,0,3,20,20,15,5,1,0,1,13,15,12,3,7,4,31,13,18,5,4,18,4,"1150-237"
"365",11,0,10,9,0,11,10,1,0,0,0,2,92,91,66,25,5,10,41,17,67,45,22,45,23,154,69,85,16,21,81,36,"1170-015"
"366",35,17,18,31,18,17,29,5,0,1,0,31,120,120,83,37,12,0,18,61,83,60,23,47,23,174,76,98,24,18,96,36,"1250-041"
"367",12,0,12,12,0,12,0,10,2,0,0,3,236,236,180,56,31,2,45,129,180,120,60,113,51,424,210,214,62,48,213,101,"1170-047"
"368",22,0,21,10,0,22,18,2,2,0,0,17,136,136,100,36,11,11,38,57,100,61,39,64,29,272,155,117,29,34,165,44,"1150-017"
"369",19,2,17,17,2,17,11,8,0,0,0,5,101,101,65,36,1,1,36,21,65,51,14,38,14,137,73,64,11,12,87,27,"1170-375"
"370",16,1,15,16,1,15,6,9,0,0,1,9,122,122,95,27,5,2,46,40,95,65,30,63,24,216,103,113,30,16,124,46,"1170-998"
"371",1,1,0,1,1,0,0,1,0,0,0,0,1,1,0,1,0,0,0,0,0,0,0,0,0,0,0,0,0,0,0,0,"1250-070"
"372",26,13,13,24,5,21,12,1,4,4,5,5,100,100,73,27,19,26,36,29,73,53,20,53,20,168,77,91,18,17,87,46,"1250-251"
"373",0,0,0,0,0,0,0,0,0,0,0,0,0,0,0,0,0,0,0,0,0,0,0,0,0,0,0,0,0,0,0,0,"1900-183"
"374",57,40,17,56,48,9,25,26,4,1,1,48,132,132,91,41,20,17,23,51,91,63,28,52,27,193,102,91,22,17,120,34,"1950-042"
"375",14,0,14,14,0,14,0,0,14,0,0,12,168,168,158,10,125,3,6,148,158,63,95,155,93,541,255,286,102,79,279,81,"1500-536"
"376",8,8,0,8,3,5,0,5,1,2,0,1,9,9,8,1,1,8,7,1,8,3,5,7,2,24,11,13,2,3,6,13,"1400-005"
"377",35,9,26,30,11,24,10,24,1,0,0,20,203,203,148,55,9,9,64,79,148,118,30,77,32,278,120,158,30,24,134,90,"1300-402"
"378",8,4,4,8,5,3,0,5,3,0,0,1,22,22,19,3,4,14,14,3,19,10,9,17,10,53,24,29,15,5,21,12,"1300-001"
"379",21,21,0,21,18,3,13,4,1,3,0,4,21,21,18,3,3,4,16,1,18,8,10,12,8,50,21,29,8,7,27,8,"1400-077"
"380",23,11,12,20,11,12,6,16,0,0,1,3,137,137,109,28,18,1,57,40,109,75,34,65,31,233,103,130,32,18,115,68,NA
"381",18,18,0,18,3,15,0,16,2,0,0,13,18,18,12,6,5,12,11,0,12,8,4,10,4,29,16,13,3,3,12,11,"1449-026"
"382",24,21,3,24,22,2,13,10,1,0,0,16,41,41,27,13,7,7,2,22,28,19,9,17,2,59,29,30,4,2,30,23,"1300-343"
"383",27,12,15,27,11,16,5,17,1,1,3,9,148,148,99,49,12,9,48,43,99,79,20,50,22,187,79,108,20,20,106,41,"1300-104"
"384",14,10,4,12,12,2,8,5,0,1,0,3,22,22,15,7,3,1,9,6,15,11,4,6,4,29,14,15,8,1,17,3,"1350-353"
"385",25,6,19,20,14,11,11,10,0,2,2,11,118,118,74,44,8,21,32,40,74,66,8,32,8,117,58,59,6,4,63,44,"1300-402"
"386",0,0,0,0,0,0,0,0,0,0,0,0,0,0,0,0,0,0,0,0,0,0,0,0,0,0,0,0,0,0,0,0,"1400-038"
"387",9,0,9,9,0,9,0,0,0,9,0,0,102,102,62,40,24,62,40,21,62,37,25,43,26,149,73,76,29,14,96,10,"1400-280"
"388",6,6,0,6,6,0,2,4,0,0,0,3,9,9,5,4,2,0,0,3,5,3,2,4,1,12,6,6,2,0,7,3,"1400-030"
"389",23,17,6,23,13,10,14,0,1,5,3,9,48,48,29,19,9,11,13,14,29,20,9,19,6,62,33,29,6,5,31,20,"1400-280"
"390",13,8,5,13,9,4,9,3,1,0,0,10,28,28,25,3,3,0,7,15,25,20,5,13,5,49,22,27,7,2,29,11,"1400-280"
"391",5,1,4,5,0,5,3,2,0,0,0,1,30,30,21,9,0,1,13,5,21,10,11,18,12,58,32,26,15,7,25,11,"1400-113"
"392",25,13,12,25,12,13,12,13,0,0,0,10,79,79,42,36,2,0,8,28,43,37,6,21,6,79,35,44,5,5,45,24,"1400-035"
"393",0,0,0,0,0,0,0,0,0,0,0,0,0,0,0,0,0,0,0,0,0,0,0,0,0,0,0,0,0,0,0,0,"1400-032"
"394",62,24,38,60,29,33,39,20,2,0,1,18,274,274,183,91,18,11,68,103,183,144,39,94,34,351,162,189,34,27,169,121,"1400-290"
"395",6,5,0,5,6,0,5,1,0,0,0,4,9,9,5,4,2,0,0,4,5,4,1,4,1,11,4,7,0,2,6,3,"1400"
"396",24,19,5,24,14,10,0,24,0,0,0,5,66,66,51,15,9,15,24,22,51,30,21,37,19,143,61,82,24,14,53,52,"1400-290"
"397",3,2,0,3,1,2,0,3,0,0,0,0,3,2,2,0,0,2,2,0,2,2,0,0,0,23,5,18,0,0,2,21,"1400-113"
"398",17,17,0,17,15,2,0,15,0,0,2,4,17,17,13,4,4,12,12,0,13,8,5,12,4,35,18,17,4,4,19,8,"1800-364"
"399",15,1,14,14,0,15,1,0,8,6,0,0,227,227,193,34,159,190,155,19,193,147,46,109,49,375,173,202,40,32,197,106,"1500-995"
"400",10,0,10,10,0,10,0,0,8,2,0,7,119,119,100,19,90,98,82,13,100,61,39,74,38,245,117,128,40,28,135,42,"1990-197"
"401",5,0,5,2,0,5,0,0,5,0,0,5,322,322,285,37,46,3,145,127,285,149,136,231,98,758,358,400,96,83,368,211,"1950-172"
"402",17,0,17,15,0,17,0,13,3,1,0,14,176,176,130,46,8,16,40,74,130,102,28,65,26,247,99,148,28,19,121,79,"1500-231"
"403",41,0,41,31,0,41,0,39,2,0,0,13,345,345,238,107,41,51,131,85,238,180,58,132,60,481,204,277,56,48,236,141,"1700-346"
"404",34,1,33,32,1,33,1,31,1,1,0,18,326,326,255,71,16,13,96,148,255,198,57,129,45,487,203,284,35,50,266,136,"1500-175"
"405",13,0,13,12,0,13,0,13,0,0,0,13,168,168,120,48,6,0,56,53,120,90,30,70,25,240,100,140,28,18,105,89,"1500-530"
"406",27,26,0,27,14,13,0,25,1,0,1,2,30,29,26,3,10,26,22,1,26,12,14,20,13,95,43,52,19,9,52,15,"1700-112"
"407",14,0,14,12,0,14,0,12,2,0,0,0,109,109,99,10,7,3,67,23,99,59,40,69,30,235,110,125,27,24,135,49,"1600-155"
"408",3,0,3,2,0,3,0,0,3,0,0,3,157,157,118,39,80,4,82,24,118,90,28,62,19,227,96,131,19,19,121,68,"1500-275"
"409",10,0,10,8,0,10,0,9,1,0,0,4,78,78,68,10,2,4,51,10,68,46,22,43,20,147,66,81,13,19,74,41,"1600-155"
"410",18,0,18,13,0,18,0,12,6,0,0,0,279,279,235,44,51,132,166,48,235,165,70,150,58,513,216,297,61,39,250,163,"1600-155"
"411",10,0,10,10,0,10,0,10,0,0,0,10,116,116,80,36,3,0,46,27,80,57,23,48,18,164,77,87,20,9,77,58,"1500-530"
"412",25,2,22,23,2,23,0,25,0,0,0,18,166,165,133,32,6,2,40,86,133,88,45,71,40,313,137,176,51,41,146,75,"1700-271"
"413",28,0,28,28,0,28,0,22,2,4,0,0,425,425,338,87,80,116,215,108,338,260,78,186,75,662,286,376,74,51,346,191,"1500-369"
"414",14,14,0,14,0,14,0,0,14,0,0,9,14,14,13,1,3,13,13,0,13,11,2,11,1,27,11,16,0,1,15,11,"1600-057"
"415",18,0,18,14,0,18,1,17,0,0,0,10,328,328,268,60,18,40,144,110,268,190,78,159,61,554,229,325,59,41,262,192,"1500-231"
"416",4,0,4,2,0,4,0,4,0,0,0,4,38,38,28,10,1,0,15,12,28,22,6,18,5,56,23,33,7,2,26,21,"1500-545"
"417",3,0,3,0,0,3,0,0,0,3,0,0,101,101,83,18,82,83,58,19,83,54,29,45,31,186,86,100,41,16,111,18,"1500-441"
"418",8,0,8,6,0,8,0,8,0,0,0,1,152,152,119,33,61,5,73,33,119,103,16,51,21,201,83,118,16,17,105,63,"1600-155"
"419",16,0,16,14,0,16,0,14,2,0,0,0,374,374,257,117,98,212,178,53,257,174,83,172,75,557,252,305,74,34,296,153,"1500-592"
"420",8,0,8,8,0,8,0,0,7,1,0,0,86,86,71,15,61,71,62,8,71,41,30,52,33,175,82,93,31,24,98,22,"1990-024"
"421",12,0,12,12,0,12,0,11,0,1,0,12,149,149,110,39,18,0,53,47,110,81,29,60,24,216,96,120,14,23,123,56,"1500-545"
"422",15,2,13,14,0,15,0,15,0,0,0,6,89,89,72,17,3,2,27,31,72,44,28,40,24,168,69,99,26,22,84,36,"1700-248"
"423",6,6,0,6,5,1,0,5,1,0,0,0,6,6,6,0,0,3,4,2,6,4,2,4,2,13,6,7,0,4,4,5,"1349-016"
"424",3,0,3,1,0,3,3,0,0,0,0,2,14,14,11,3,0,0,1,10,11,9,2,6,3,23,7,16,1,2,15,5,"1100-062"
"425",8,2,6,3,0,8,6,0,1,1,0,1,35,35,12,23,4,0,7,5,12,8,4,7,4,24,13,11,6,0,14,4,"1200-466"
"426",42,42,0,42,42,0,1,41,0,0,0,1,42,42,23,19,1,0,0,22,23,21,2,9,2,37,11,26,0,2,8,27,"1349-016"
"427",13,0,12,12,0,13,0,12,0,1,0,12,90,89,61,28,4,1,37,21,61,49,12,32,15,121,53,68,16,6,65,34,"1350-102"
"428",10,0,10,10,0,10,9,1,0,0,0,10,92,92,72,20,7,0,42,26,72,44,28,50,31,174,78,96,28,27,82,37,"1350-036"
"429",12,1,11,12,2,10,0,12,0,0,0,0,104,104,79,25,24,14,43,25,79,58,21,41,22,161,66,95,22,20,85,34,"1350-102"
"430",13,8,3,11,10,3,0,5,8,0,0,3,24,22,17,5,1,1,2,14,18,13,5,9,3,65,35,30,1,3,31,30,"1100-085"
"431",24,1,23,21,2,22,22,2,0,0,0,12,162,162,123,39,5,4,55,63,123,81,42,69,36,274,133,141,30,32,156,56,"1170-051"
"432",5,1,4,4,1,4,4,1,0,0,0,5,25,25,22,3,4,7,19,3,22,15,7,17,6,49,26,23,7,1,28,13,"1300-053"
"433",15,0,15,11,0,15,8,7,0,0,0,6,93,93,67,26,1,0,21,42,67,48,19,35,20,130,61,69,22,10,81,17,"1170-047"
"434",25,0,25,23,0,25,23,1,0,1,0,15,149,149,112,37,5,0,49,60,112,82,30,60,29,224,100,124,21,24,136,43,"1350-097"
"435",13,11,2,13,13,0,0,13,0,0,0,1,18,18,15,3,2,2,14,1,15,10,5,13,4,35,19,16,3,4,15,13,"1400-036"
"436",2,1,1,2,0,2,1,0,0,1,0,0,8,8,6,2,2,1,5,1,6,3,3,6,2,18,11,7,1,2,13,2,"1169-017"
"437",16,0,16,8,0,16,15,1,0,0,0,2,115,115,85,30,4,1,40,39,85,45,40,49,24,240,125,115,28,23,150,39,"1150-334"
"438",10,1,8,8,0,10,0,4,5,1,0,2,372,371,322,49,149,53,211,91,322,189,133,227,107,763,357,406,114,65,417,167,"1950-172"
"439",5,2,3,5,0,5,0,0,0,5,0,0,24,24,17,7,17,17,15,2,17,11,6,12,7,39,21,18,5,10,18,6,"1990-024"
"440",6,0,6,4,0,6,0,0,6,0,0,0,149,149,123,26,111,61,101,17,123,78,45,69,35,270,120,150,30,27,148,65,"1600-477"
"441",8,0,8,5,0,8,0,0,0,8,0,0,98,98,77,21,70,77,63,11,77,40,37,60,43,193,100,93,34,30,109,20,"1990-070"
"442",11,0,11,9,0,11,0,0,11,0,0,0,129,129,109,20,4,5,72,20,109,78,31,55,28,221,96,125,21,25,117,58,"1500-450"
"443",10,10,0,10,10,0,0,10,0,0,0,2,10,10,9,1,4,5,9,0,9,3,6,8,5,32,14,18,6,5,16,5,"1950-097"
"444",7,0,7,4,0,7,0,0,0,7,0,0,103,103,78,25,65,78,60,13,78,38,40,62,39,203,100,103,38,24,119,22,"1990-221"
"445",23,20,3,23,20,3,0,20,3,0,0,1,68,68,48,20,5,44,39,6,48,27,21,36,22,123,66,57,15,23,66,19,"1800-999"
"446",19,19,0,19,19,0,0,0,11,8,0,18,19,19,12,7,6,3,0,2,12,11,1,8,3,23,13,10,0,4,16,3,"1600-404"
"447",17,0,17,17,0,17,0,0,17,0,0,0,180,180,150,30,103,133,134,8,150,92,58,110,52,357,173,184,38,46,197,76,"1600-477"
"448",17,0,17,17,0,17,0,13,4,0,0,6,170,170,153,17,43,0,95,51,153,102,51,99,38,341,168,173,23,37,158,123,"1950-037"
"449",16,0,16,12,0,16,15,1,0,0,0,12,117,117,82,35,8,8,36,45,82,54,28,49,29,182,79,103,33,17,104,28,"1300-375"
"450",27,19,8,24,24,3,20,1,0,5,1,7,58,58,36,22,3,8,13,20,36,29,7,14,5,65,29,36,5,6,37,17,"1400-203"
"451",4,3,1,4,3,1,3,1,0,0,0,3,6,6,5,1,1,2,0,4,5,5,0,2,2,7,3,4,0,2,3,2,"1200-690"
"452",0,0,0,0,0,0,0,0,0,0,0,0,0,0,0,0,0,0,0,0,0,0,0,0,0,0,0,0,0,0,0,0,"1400-206"
"453",9,9,0,9,7,2,0,9,0,0,0,3,9,9,7,2,3,4,6,1,7,2,5,7,5,22,9,13,4,4,12,2,"1400-113"
"454",8,8,0,8,8,0,0,8,0,0,0,2,8,8,7,1,0,4,6,0,7,4,3,6,3,20,5,15,1,6,7,6,"1400-113"
"455",36,19,17,35,19,17,14,19,3,0,0,3,132,132,103,29,15,40,64,30,103,72,31,64,23,223,107,116,24,21,97,81,"1400-290"
"456",8,8,0,8,8,0,0,8,0,0,0,5,8,8,6,2,1,5,6,0,6,3,3,5,3,19,9,10,4,5,6,4,"1400-085"
"457",26,19,7,25,20,6,18,1,4,3,0,9,76,76,50,26,29,27,37,9,50,27,23,35,22,133,71,62,34,13,65,21,"1400-088"
"458",21,0,21,17,1,20,0,11,5,5,0,1,261,261,193,68,56,31,111,64,193,146,47,106,41,374,164,210,45,20,190,119,"1400-035"
"459",8,8,0,8,8,0,1,7,0,0,0,1,8,8,6,2,1,6,5,1,6,3,3,6,3,18,8,10,4,0,8,6,"1400-085"
"460",19,1,18,14,0,19,11,7,1,0,0,2,146,146,111,35,2,8,58,47,111,83,28,53,24,230,115,115,20,19,144,47,"1170-099"
"461",0,0,0,0,0,0,0,0,0,0,0,0,0,0,0,0,0,0,0,0,0,0,0,0,0,0,0,0,0,0,0,0,"1000-300"
"462",16,0,15,9,0,16,3,13,0,0,0,1,147,146,117,29,25,9,55,56,117,78,39,71,30,280,125,155,35,36,120,89,"1000-052"
"463",12,4,8,12,1,11,10,1,0,1,0,6,51,51,40,11,4,6,24,13,40,27,13,17,11,83,40,43,10,6,57,10,"1600-993"
"464",11,1,10,8,1,10,3,7,0,0,1,4,114,114,68,46,14,30,42,21,68,39,29,43,20,161,71,90,24,15,83,39,"1050-036"
"465",14,0,13,11,0,14,0,8,6,0,0,0,132,131,73,58,9,2,6,65,73,57,16,39,15,192,75,117,15,7,69,101,"1500-542"
"466",22,0,22,19,1,21,0,22,0,0,0,0,208,208,168,40,19,18,86,66,168,138,30,79,34,310,133,177,37,26,153,94,"1500-559"
"467",20,0,20,11,0,20,15,5,0,0,0,1,232,232,178,54,27,1,104,53,178,112,66,124,59,434,204,230,59,51,208,116,"1000-192"
"468",21,0,20,12,0,21,0,21,0,0,0,15,290,289,224,65,47,23,54,151,225,138,87,143,83,514,234,280,100,45,272,97,"1000-996"
"469",30,0,30,28,0,30,0,0,30,0,0,2,310,310,282,27,107,2,93,181,283,171,112,207,102,711,339,372,95,92,358,166,"1950-363"
"470",14,0,14,7,0,14,0,3,9,2,0,0,644,644,488,156,368,477,340,110,488,369,119,267,120,986,453,533,98,115,571,202,"1900-221"
"471",24,3,21,22,3,21,2,17,5,0,0,14,150,150,108,42,17,22,55,43,108,92,16,47,16,186,85,101,14,17,99,56,"1600-993"
"472",6,2,4,3,0,6,6,0,0,0,0,6,25,25,16,9,0,0,7,8,16,12,4,9,2,34,16,18,4,1,22,7,"1100-172"
"473",20,14,6,20,15,5,8,12,0,0,0,8,59,59,40,19,4,0,8,32,40,27,13,25,11,89,32,57,11,4,50,24,"1170-167"
"474",28,7,21,22,2,26,15,12,0,1,0,18,149,149,94,55,8,10,26,61,94,62,32,48,27,215,99,116,33,32,120,30,"1250-268"
"475",23,3,18,19,1,22,18,4,1,0,0,4,125,123,105,18,5,19,49,48,105,70,35,59,30,250,122,128,34,33,131,52,"1250-101"
"476",34,5,29,30,10,24,16,13,4,0,1,6,210,210,159,51,12,22,64,78,159,124,35,68,30,295,146,149,33,24,175,63,"1250-263"
"477",19,1,18,19,1,18,6,12,1,0,0,7,133,133,98,35,16,5,53,40,98,76,22,53,23,188,79,109,27,14,96,51,"1350-145"
"478",17,0,17,16,0,17,1,13,0,3,0,1,174,174,147,27,24,21,46,89,147,113,34,67,32,276,118,158,35,18,146,77,"1350-168"
"479",25,1,24,13,0,25,1,23,0,0,1,5,81,81,54,27,3,2,19,32,54,38,16,27,14,105,52,53,15,10,63,17,"1150-251"
"480",33,13,20,28,17,16,11,18,1,2,1,14,156,156,118,38,26,21,59,52,118,89,29,53,30,229,104,125,41,22,122,44,"1250-212"
"481",17,4,13,13,5,12,8,8,1,0,0,9,70,70,46,24,1,1,24,21,46,41,5,16,6,72,32,40,4,6,35,27,"1170-047"
"482",30,2,28,24,0,30,28,2,0,0,0,21,118,118,77,41,6,2,15,55,77,48,29,39,18,210,128,82,22,19,143,26,"1150-199"
"483",18,5,12,13,8,10,11,3,3,1,0,8,129,128,87,41,25,21,44,33,87,60,27,50,17,250,92,158,17,13,85,135,"1170-358"
"484",11,2,9,9,6,5,10,1,0,0,0,4,48,48,35,13,2,0,9,26,35,29,6,16,6,65,28,37,8,4,40,13,"1170-381"
"485",36,23,13,32,24,12,26,10,0,0,0,3,96,96,73,23,2,1,16,56,73,59,14,40,17,149,72,77,15,10,89,35,"1170-169"
"486",14,0,14,8,0,14,0,13,0,0,1,4,118,118,76,42,1,3,22,48,76,50,26,44,25,167,82,85,24,18,98,27,"1150-346"
"487",5,1,4,3,0,5,0,4,0,0,1,0,39,39,15,24,5,7,5,6,15,10,5,12,4,33,13,20,3,3,22,5,"1250-043"
"488",23,0,23,17,0,23,0,23,0,0,0,22,340,340,274,66,117,3,119,130,274,183,91,159,79,598,267,331,88,51,323,136,"1700-198"
"489",7,0,7,6,0,7,0,5,2,0,0,1,161,161,132,29,47,61,96,20,132,100,32,64,25,248,96,152,17,27,127,77,"1500-085"
"490",8,0,8,1,0,8,0,5,3,0,0,0,243,243,188,55,114,3,121,46,188,135,53,118,51,404,186,218,46,40,205,113,"1500-083"
"491",27,1,25,23,1,26,1,8,15,3,0,1,496,495,412,83,218,366,326,59,412,275,137,263,113,906,428,478,84,97,449,276,"1500-459"
"492",14,0,14,12,0,14,0,14,0,0,0,0,238,238,179,59,61,4,94,50,179,135,44,89,32,338,153,185,27,21,182,108,"1700-178"
"493",14,4,10,13,8,6,10,0,0,4,0,10,103,103,83,20,50,55,51,24,83,62,21,41,26,158,77,81,26,16,92,24,"1300-120"
"494",16,1,15,15,1,15,1,15,0,0,0,3,109,109,83,26,3,0,49,29,83,61,22,47,22,163,75,88,20,10,87,46,"1300-104"
"495",28,13,15,28,15,13,18,8,1,1,0,9,112,112,67,45,8,0,22,40,67,51,16,37,15,131,62,69,8,12,73,38,"1300-481"
"496",17,16,1,17,3,14,0,13,2,1,1,3,20,20,14,6,3,13,12,0,14,8,6,9,5,34,14,20,4,5,18,7,"1400-297"
"497",15,4,11,14,4,11,12,3,0,0,0,6,48,48,16,32,0,0,4,9,16,16,0,1,0,23,13,10,0,1,14,8,"1200-047"
"498",31,8,23,19,6,25,31,0,0,0,0,15,98,98,54,44,3,1,8,42,54,45,9,22,6,95,41,54,9,5,50,31,"1100-543"
"499",2,0,2,2,0,2,0,2,0,0,0,2,31,31,21,10,0,2,19,2,21,15,6,8,4,42,22,20,2,9,22,9,"1350-097"
"500",11,2,9,10,1,10,9,1,0,0,1,4,40,40,14,26,0,0,8,5,14,8,6,9,2,32,12,20,1,3,20,8,"1250-135"
"501",73,13,60,67,24,49,69,1,2,1,0,9,355,355,258,97,23,20,90,150,258,198,60,136,48,502,232,270,50,33,303,116,"1170-381"
"502",43,14,29,37,8,35,20,19,1,3,0,5,262,262,200,62,48,62,106,71,200,126,74,124,72,472,228,244,82,51,231,108,"1250-090"
"503",6,0,6,3,0,6,5,0,0,1,0,4,54,54,29,25,15,15,13,13,29,23,6,12,6,52,29,23,3,6,35,8,"1250-146"
"504",25,9,16,17,10,15,19,4,0,1,1,12,107,107,81,26,1,5,35,45,81,67,14,41,13,154,81,73,14,10,103,27,"1100-085"
"505",14,2,12,12,7,7,0,14,0,0,0,2,63,63,42,21,2,1,8,31,42,30,12,17,10,91,47,44,9,13,52,17,"1170-381"
"506",5,0,5,4,0,5,4,0,0,0,1,5,29,29,18,11,0,0,1,16,18,16,2,6,1,30,14,16,0,2,18,10,"1100-285"
"507",7,3,3,5,4,3,3,4,0,0,0,6,25,23,13,10,3,3,3,9,13,10,3,2,1,44,39,5,0,1,39,4,"1100-285"
"508",22,4,18,21,4,18,7,12,0,2,1,7,132,132,109,23,18,19,29,70,109,86,23,50,24,202,93,109,23,13,120,46,"1350-145"
"509",8,1,7,5,1,7,2,5,0,1,0,4,48,48,39,9,1,9,19,19,39,27,12,19,12,83,37,46,14,10,42,17,"1250-212"
"510",14,0,14,11,0,14,3,11,0,0,0,0,175,175,134,41,12,6,40,85,134,113,21,58,19,233,91,142,21,9,124,79,"1350-273"
"511",58,56,2,58,52,6,56,0,0,1,1,20,73,73,49,24,13,11,11,35,49,39,10,23,14,92,47,45,15,4,54,19,"1250-151"
"512",11,3,7,9,2,9,6,1,4,0,0,2,53,52,39,13,6,4,4,34,39,25,14,26,11,97,47,50,11,9,54,23,"1170-169"
"513",80,28,51,74,35,45,4,70,4,1,1,32,400,399,297,102,56,31,131,147,297,209,88,174,83,633,270,363,99,63,312,159,"1350-102"
"514",20,12,7,16,13,7,14,0,0,5,1,13,69,68,44,24,10,0,5,36,44,17,27,44,23,152,82,70,33,17,87,15,"1349-055"
"515",10,2,8,9,2,8,6,4,0,0,0,5,38,38,17,21,1,3,7,8,17,13,4,7,3,28,15,13,4,0,21,3,"1200-043"
"516",6,0,6,5,0,6,0,6,0,0,0,5,53,53,48,5,1,0,9,36,48,39,9,28,8,91,39,52,6,7,36,42,"1900-046"
"517",33,6,27,26,1,32,24,9,0,0,0,4,111,111,62,49,4,0,20,41,62,45,17,41,12,130,70,60,10,10,78,32,"1150-291"
"518",76,60,16,75,61,15,56,14,4,2,0,58,167,167,126,41,15,2,11,111,126,74,52,91,48,321,145,176,46,37,178,60,"1070"
"519",27,15,12,25,22,5,24,1,0,2,0,22,67,67,52,15,4,0,13,37,52,39,13,25,13,106,48,58,17,11,53,25,"1350-102"
"520",6,1,5,3,0,6,6,0,0,0,0,0,22,22,17,5,0,0,7,7,17,12,5,10,3,36,19,17,3,6,17,10,"1250-008"
"521",59,6,53,46,9,50,29,27,1,2,0,32,387,387,228,159,17,17,116,92,228,150,78,119,68,521,263,258,52,56,309,104,"1170-108"
"522",5,0,5,2,0,5,5,0,0,0,0,2,16,16,6,10,0,0,3,2,6,5,1,2,0,9,5,4,0,0,8,1,"1100-054"
"523",14,0,14,11,0,14,0,5,4,0,5,0,268,268,194,74,115,142,112,65,194,137,57,122,55,428,196,232,66,38,221,103,"1600-152"
"524",6,1,5,1,0,6,3,0,1,2,0,0,29,29,14,15,7,7,6,6,14,14,0,6,1,20,12,8,1,0,10,9,"1200-022"
"525",8,8,0,8,6,2,0,7,1,0,0,1,8,8,7,1,1,6,7,0,7,3,4,6,4,21,12,9,5,3,10,3,"1349-016"
"526",10,0,10,10,0,10,0,10,0,0,0,8,140,140,111,29,3,1,65,41,111,71,40,81,33,254,107,147,30,21,117,86,"1300-504"
"527",12,0,12,11,0,12,4,8,0,0,0,11,167,167,135,32,9,1,73,57,135,75,60,105,43,342,167,175,45,35,178,84,"1300-253"
"528",8,0,8,8,0,8,0,7,1,0,0,7,86,86,74,12,34,17,49,20,74,38,36,56,35,202,93,109,27,43,99,33,"1350-179"
"529",8,3,5,6,0,8,8,0,0,0,0,3,27,27,15,12,2,0,0,14,15,12,3,4,1,26,15,11,2,4,14,6,"1200-471"
"530",7,1,5,6,2,5,7,0,0,0,0,3,19,18,10,8,1,1,2,8,10,8,2,5,1,21,8,13,1,2,14,4,"1100-081"
"531",6,2,4,2,1,5,6,0,0,0,0,4,16,16,9,7,3,0,4,3,9,5,4,4,3,22,11,11,4,5,10,3,"1100-042"
"532",1,0,1,0,0,1,1,0,0,0,0,0,8,8,4,4,0,0,3,1,4,3,1,1,1,7,4,3,2,0,4,1,"1200-205"
"533",13,0,13,7,0,13,13,0,0,0,0,11,57,57,38,19,1,0,11,25,38,31,7,15,6,78,36,42,4,6,47,21,"1200-383"
"534",8,1,7,6,1,7,7,0,1,0,0,4,35,35,16,19,0,1,4,8,16,12,4,8,3,31,16,15,3,0,23,5,"1200-012"
"535",4,1,3,4,1,3,4,0,0,0,0,1,13,13,7,6,0,0,2,4,7,5,2,4,2,15,9,6,0,2,8,5,"1200-047"
"536",11,0,11,11,0,11,9,1,0,0,1,3,63,63,43,20,3,4,23,14,43,25,18,32,17,116,58,58,17,21,55,23,"1200-660"
"537",17,0,17,5,0,17,15,0,0,2,0,0,136,136,86,50,27,30,43,39,86,59,27,53,21,186,91,95,17,14,104,51,"1200-651"
"538",6,0,6,2,0,6,0,6,0,0,0,1,105,105,79,26,10,0,60,16,79,65,14,37,14,143,64,79,16,6,65,56,"1500-103"
"539",4,3,1,3,0,4,0,4,0,0,0,3,31,31,23,8,7,1,13,6,23,14,9,13,7,53,29,24,6,6,34,7,"1700-198"
"540",12,8,4,12,6,6,0,10,0,2,0,0,40,40,35,5,11,15,25,7,35,20,15,22,16,87,37,50,15,11,41,20,"1500-481"
"541",45,16,29,44,13,32,20,17,8,0,0,16,234,234,180,54,27,32,78,92,180,129,51,101,48,366,160,206,50,27,194,95,"1300-001"
"542",16,6,10,15,3,13,0,14,0,1,1,4,72,72,56,16,12,9,28,24,56,40,16,35,16,118,50,68,17,10,65,26,"1200-716"
"543",72,33,39,62,33,39,47,6,8,10,1,16,232,232,154,78,18,15,48,95,154,115,39,68,40,304,136,168,34,35,185,50,"1200-786"
"544",116,78,38,113,84,32,86,20,6,3,1,74,337,337,247,90,17,3,69,164,247,181,66,151,60,510,220,290,58,37,285,130,"1300-996"
"545",19,14,5,19,16,3,13,4,2,0,0,13,45,45,33,12,15,16,18,15,33,20,13,17,11,75,30,45,17,7,38,13,"1350-261"
"546",8,2,6,7,7,1,3,5,0,0,0,0,26,26,22,4,1,0,14,7,22,17,5,14,6,51,26,25,6,7,28,10,"1350-070"
"547",11,0,10,6,0,11,7,3,0,0,1,5,123,122,93,29,2,7,60,24,93,60,33,55,32,236,108,128,44,13,113,66,"1300-328"
"548",29,0,29,23,0,29,0,29,0,0,0,20,319,319,248,71,19,2,130,100,248,180,68,139,61,505,218,287,62,47,222,174,"1300-250"
"549",14,13,1,14,12,2,13,0,0,0,1,6,17,17,11,6,3,0,5,6,11,8,3,5,2,21,7,14,3,1,11,6,"1300-996"
"550",29,29,0,29,29,0,0,29,0,0,0,8,29,29,25,4,10,0,17,7,25,17,8,18,6,58,29,29,5,4,31,18,"1950-449"
"551",18,0,17,14,0,18,1,17,0,0,0,0,187,186,143,43,13,0,46,90,143,116,27,64,23,259,107,152,23,14,140,82,"1700-145"
"552",12,3,7,11,5,7,5,2,5,0,0,7,84,82,71,11,59,63,47,14,71,41,30,56,24,247,110,137,30,18,100,99,"1700-043"
"553",30,30,0,30,30,0,0,30,0,0,0,11,30,30,25,5,5,4,23,1,25,5,20,23,17,85,45,40,22,10,46,7,"1500-599"
"554",14,0,14,9,0,14,4,9,0,1,0,6,125,125,92,33,19,11,46,31,92,61,31,46,26,200,80,120,25,25,109,41,"1700-159"
"555",20,20,0,20,18,2,0,19,1,0,0,0,20,20,17,3,6,9,17,0,17,9,8,16,5,44,19,25,8,0,24,12,"1500-481"
"556",23,0,23,20,0,23,5,18,0,0,0,7,191,191,136,55,7,4,38,81,136,113,23,56,16,242,99,143,19,2,139,82,"1700-145"
"557",0,0,0,0,0,0,0,0,0,0,0,0,0,0,0,0,0,0,0,0,0,0,0,0,0,0,0,0,0,0,0,0,"1900-793"
"558",7,0,7,7,0,7,0,0,7,0,0,1,139,139,125,14,53,121,109,7,125,71,54,103,46,328,152,176,41,47,142,98,"1500-441"
"559",14,0,14,14,0,14,0,0,0,14,0,0,257,257,230,27,211,225,189,25,230,132,98,148,102,535,262,273,112,40,328,55,"1950-266"
"560",1,0,0,1,1,0,0,0,0,1,0,0,1,0,0,0,0,0,0,0,0,0,0,0,0,9,4,5,8,1,0,0,"1900-793"
"561",10,0,10,7,0,10,0,10,0,0,0,7,151,151,121,30,0,9,45,66,121,79,42,72,40,276,131,145,52,30,147,47,"1749-113"
"562",21,21,0,21,21,0,0,19,0,2,0,12,21,21,15,6,3,9,13,0,15,6,9,14,8,48,21,27,12,6,18,12,"1500-599"
"563",22,13,9,21,14,8,10,1,6,3,2,9,147,147,105,42,59,93,79,21,105,58,47,77,38,256,120,136,36,26,149,45,"1600-140"
"564",34,34,0,34,34,0,0,34,0,0,0,12,34,34,33,1,8,2,26,5,33,20,13,25,7,77,37,40,5,5,37,30,"1950-449"
"565",34,0,34,29,0,34,0,33,1,0,0,32,389,389,319,70,18,16,149,143,319,226,93,171,87,651,280,371,93,60,361,137,"1749-113"
"566",7,0,7,3,0,7,0,0,7,0,0,0,241,241,181,60,150,176,131,39,181,122,59,116,61,397,179,218,51,45,225,76,"1600-042"
"567",3,0,3,2,0,3,0,0,0,3,0,0,191,191,146,45,133,143,106,21,146,89,57,81,45,347,183,164,43,49,235,20,"1950-340"
"568",6,0,6,6,0,6,0,0,6,0,0,4,120,120,102,18,12,0,60,35,102,67,35,67,31,220,107,113,31,20,108,61,"1950-230"
"569",123,93,29,121,8,115,0,121,2,0,0,21,421,418,331,87,44,59,163,138,331,213,118,205,107,770,360,410,116,94,376,184,"1700-043"
"570",3,1,2,3,0,3,3,0,0,0,0,0,15,15,10,5,0,0,6,4,10,5,5,6,2,22,10,12,1,1,14,6,"1200-310"
"571",5,3,2,3,0,5,3,0,0,2,0,1,12,12,5,7,0,0,0,4,5,5,0,1,1,8,3,5,1,2,3,2,"1200-260"
"572",3,1,2,2,1,2,2,0,0,1,0,1,8,8,5,3,1,0,1,3,5,4,1,1,0,11,9,2,0,1,9,1,"1200-410"
"573",0,0,0,0,0,0,0,0,0,0,0,0,0,0,0,0,0,0,0,0,0,0,0,0,0,0,0,0,0,0,0,0,"1200-128"
"574",15,1,14,6,0,15,15,0,0,0,0,3,54,54,42,12,1,0,11,28,42,30,12,17,10,78,36,42,10,6,44,18,"1200-335"
"575",7,1,6,3,1,6,7,0,0,0,0,3,22,22,20,2,2,1,11,8,20,13,7,12,8,52,30,22,8,10,25,9,"1100-404"
"576",25,3,22,17,2,23,21,4,0,0,0,10,140,140,91,49,10,4,25,59,91,60,31,55,28,203,92,111,35,18,115,35,"1200-651"
"577",6,1,5,5,1,5,3,0,0,2,1,5,28,28,9,19,1,0,6,3,9,9,0,3,0,14,6,8,0,2,11,1,"1150-199"
"578",1,0,1,0,0,1,0,0,0,0,1,0,8,8,5,3,0,0,2,3,5,4,1,1,1,9,3,6,2,0,5,2,"1250-102"
"579",11,1,10,10,1,10,0,5,4,1,1,10,101,101,85,16,10,15,36,44,85,67,18,44,17,166,71,95,15,12,88,51,"1250-153"
"580",7,1,6,6,1,6,5,2,0,0,0,0,37,37,24,13,2,0,14,6,24,15,9,15,3,56,25,31,2,4,40,10,"1100-254"
"581",21,2,19,20,1,20,13,6,1,1,0,6,137,137,112,25,14,8,42,62,112,78,34,66,36,240,105,135,44,15,124,57,"1350-166"
"582",21,1,20,18,1,20,7,13,0,1,0,5,117,117,83,34,7,7,43,34,83,55,28,46,30,183,87,96,37,18,95,33,"1350-037"
"583",47,19,28,37,13,34,47,0,0,0,0,29,150,150,100,50,1,5,20,71,100,73,27,53,21,198,92,106,21,17,109,51,"1170-165"
"584",17,1,16,16,0,17,5,9,1,1,1,0,142,142,101,41,7,17,47,47,101,64,37,57,34,230,94,136,36,24,129,41,"1350-013"
"585",17,2,15,16,1,16,5,12,0,0,0,0,127,127,86,41,7,1,14,68,86,69,17,44,19,166,76,90,23,11,80,52,"1350-100"
"586",17,1,16,16,0,17,0,14,3,0,0,17,131,131,103,28,8,5,39,56,103,83,20,46,20,182,67,115,22,7,95,58,"1350-133"
"587",19,1,18,14,3,16,2,14,2,0,1,12,194,194,146,48,28,27,52,82,146,107,39,70,30,285,117,168,28,24,139,94,"1350-066"
"588",0,0,0,0,0,0,0,0,0,0,0,0,0,0,0,0,0,0,0,0,0,0,0,0,0,0,0,0,0,0,0,0,"1350-168"
"589",18,0,18,15,0,18,0,17,0,0,1,17,164,164,127,37,16,4,43,66,127,104,23,61,23,235,105,130,34,14,129,58,"1350-128"
"590",12,2,9,11,0,12,4,5,1,0,2,3,48,47,33,14,6,0,12,18,33,23,10,19,8,76,33,43,10,11,43,12,"1250-100"
"591",36,9,27,32,12,24,31,5,0,0,0,18,173,173,111,62,2,9,31,75,111,77,34,58,30,237,100,137,29,25,134,49,"1170-313"
"592",8,0,8,7,0,8,4,4,0,0,0,4,53,53,43,10,2,0,14,26,43,32,11,23,8,95,44,51,11,4,62,18,"1170-376"
"593",37,11,26,27,5,32,9,14,2,7,5,12,214,214,134,80,48,58,69,58,134,87,47,84,48,309,140,169,51,38,159,61,"1250-268"
"594",28,11,17,20,4,24,15,10,0,2,1,8,105,105,73,32,11,9,20,47,73,49,24,39,20,159,89,70,24,7,108,20,"1150-269"
"595",35,22,13,35,14,21,0,18,14,2,1,2,83,83,75,8,25,15,67,3,75,47,28,55,23,178,79,99,21,17,82,58,"1400-406"
"596",24,6,18,21,4,20,14,8,0,2,0,10,126,126,93,33,2,3,36,52,93,72,21,40,17,176,70,106,24,8,100,44,"1250-033"
"597",14,7,7,14,5,9,7,3,3,1,0,10,55,55,27,28,2,3,5,21,27,21,6,12,6,48,20,28,3,6,29,10,"1170-366"
"598",13,1,12,10,1,12,13,0,0,0,0,9,84,84,66,18,3,0,24,41,66,58,8,24,8,108,50,58,7,4,53,44,"1170-366"
"599",48,23,25,39,23,25,40,8,0,0,0,10,164,164,115,49,9,1,23,87,115,89,26,64,25,230,103,127,19,26,104,81,"1100-376"
"600",34,14,20,33,14,20,13,20,0,1,0,1,155,155,116,39,6,18,40,70,116,88,28,51,24,216,92,124,22,19,123,52,"1250-212"
"601",24,8,16,23,11,13,19,3,0,1,1,13,100,100,67,33,8,12,24,40,67,49,18,43,17,153,73,80,19,17,84,33,"1100-468"
"602",9,4,5,7,3,6,6,3,0,0,0,2,27,27,14,13,0,0,5,8,14,11,3,5,3,28,14,14,2,5,17,4,"1150-278"
"603",8,4,4,8,3,5,6,0,0,1,1,0,31,31,23,8,3,1,12,8,23,18,5,8,4,40,17,23,5,3,25,7,"1250"
"604",2,1,1,2,1,1,0,2,0,0,0,0,13,13,6,7,0,0,0,4,6,5,1,2,0,12,6,6,0,2,6,4,"1250-048"
"605",2,0,1,1,0,2,0,0,1,0,1,0,7,6,3,3,0,3,1,2,4,3,1,1,1,7,2,5,0,3,3,1,"1070-124"
"606",13,3,10,8,1,12,8,5,0,0,0,5,62,62,44,18,1,2,25,16,44,22,22,35,16,125,55,70,17,18,67,23,"1000-141"
"607",18,0,17,15,0,18,3,15,0,0,0,14,196,196,136,60,12,0,41,83,136,109,27,70,20,260,129,131,13,22,137,88,"1900-172"
"608",0,0,0,0,0,0,0,0,0,0,0,0,0,0,0,0,0,0,0,0,0,0,0,0,0,0,0,0,0,0,0,0,"1000-141"
"609",23,0,20,21,3,20,1,19,3,0,0,1,189,186,143,43,5,17,63,61,143,95,48,85,47,358,166,192,54,50,152,102,"1000-268"
"610",24,0,23,20,0,24,1,23,0,0,0,6,189,189,138,51,5,1,57,68,138,89,49,80,40,320,143,177,34,38,188,60,"1000-047"
"611",5,0,5,4,0,5,0,0,5,0,0,4,103,103,88,15,8,0,4,82,88,58,30,61,25,212,100,112,21,25,102,64,"1900-330"
"612",22,2,20,20,3,19,10,12,0,0,0,1,106,106,80,26,2,0,19,55,80,58,22,46,17,165,85,80,14,20,86,45,"1900-269"
"613",14,1,13,11,0,14,14,0,0,0,0,2,140,140,93,47,3,0,36,52,93,55,38,48,22,237,129,108,28,25,149,35,"1900-183"
"614",18,0,18,13,0,18,12,5,1,0,0,5,131,131,101,30,9,4,50,42,101,68,33,55,26,229,124,105,17,36,126,50,"1900-936"
"615",13,0,13,11,0,13,0,12,0,0,1,7,152,152,106,46,8,18,58,37,106,60,46,70,44,263,114,149,51,32,119,61,"1000-150"
"616",20,2,18,19,4,16,8,12,0,0,0,1,93,93,69,24,1,1,25,43,69,52,17,35,12,135,71,64,9,11,76,39,"1900-240"
"617",22,1,20,17,0,22,17,5,0,0,0,7,163,163,126,37,6,4,49,65,126,89,37,69,32,279,114,165,28,32,165,54,"1900-140"
"618",9,0,9,8,0,9,4,5,0,0,0,6,67,67,34,33,0,0,17,14,34,27,7,12,7,59,25,34,4,11,37,7,"1900-381"
"619",28,0,28,26,0,28,25,3,0,0,0,3,222,222,162,60,20,1,93,62,162,119,43,90,34,327,152,175,36,17,183,91,"1900-024"
"620",26,2,23,22,4,22,6,20,0,0,0,0,186,185,145,40,15,2,45,91,145,99,46,92,39,327,145,182,33,26,177,91,"1900-269"
"621",25,3,22,16,1,24,0,20,1,4,0,18,225,225,160,65,43,58,106,38,160,124,36,85,39,317,154,163,35,37,162,83,"1050-128"
"622",12,9,3,12,12,0,1,11,0,0,0,8,27,27,23,4,2,1,4,18,23,12,11,19,11,59,28,31,13,6,33,7,"1900-278"
"623",10,10,0,10,5,5,0,4,1,5,0,7,10,10,9,1,4,6,7,1,9,5,4,5,4,27,15,12,7,5,11,4,"1400-139"
"624",23,23,0,23,22,1,10,9,0,1,3,0,25,25,21,4,9,8,13,3,21,12,9,11,6,49,24,25,5,6,28,10,"1400-210"
"625",32,21,11,31,30,2,14,18,0,0,0,18,71,71,47,24,2,1,11,34,47,26,21,37,16,125,67,58,22,12,60,31,"1900-330"
"626",10,1,9,9,0,10,1,7,0,2,0,2,72,72,47,25,14,12,16,24,47,30,17,28,15,116,52,64,16,17,54,29,"1051-802"
"627",24,0,24,22,0,24,7,17,0,0,0,24,284,284,186,98,9,1,72,104,186,145,41,87,31,357,173,184,37,26,182,112,"1900-172"
"628",12,2,9,7,1,11,2,9,0,1,0,1,144,144,93,51,26,43,61,21,93,61,32,55,34,216,96,120,28,37,118,33,"1050-186"
"629",12,0,12,11,0,12,0,0,12,0,0,12,154,154,144,10,50,3,18,124,144,79,65,117,51,374,172,202,52,37,193,92,"1500-534"
"630",51,43,8,50,49,2,36,10,3,2,0,38,81,81,69,12,24,2,14,50,69,46,23,47,20,151,77,74,19,11,85,36,"1070"
"631",25,1,24,23,1,24,21,4,0,0,0,2,203,203,147,56,8,2,40,101,147,119,28,78,23,288,129,159,24,23,154,87,"1900-269"
"632",20,0,18,14,0,20,3,12,2,3,0,2,106,105,70,35,20,18,39,26,70,41,29,48,26,176,89,87,22,27,102,25,"1070-228"
"633",19,0,19,16,0,19,2,16,0,1,0,0,220,220,161,59,3,1,63,90,161,131,30,81,31,314,146,168,25,26,169,94,"1900-269"
"634",18,1,17,15,1,17,11,6,0,0,1,15,151,151,118,33,16,13,50,62,118,74,44,63,34,273,143,130,35,33,148,57,"1300-371"
"635",4,1,3,2,0,4,0,4,0,0,0,0,19,19,15,4,0,0,0,15,15,13,2,4,2,27,12,15,4,1,16,6,"1200-161"
"636",23,4,19,22,0,23,17,4,0,1,1,12,151,151,97,53,4,2,45,45,98,69,29,52,28,200,91,109,28,26,99,47,"1200-715"
"637",7,7,0,7,7,0,7,0,0,0,0,0,8,8,3,5,0,0,3,0,3,3,0,2,0,5,2,3,0,0,4,1,"1300-325"
"638",12,3,9,12,1,11,0,11,1,0,0,0,144,144,118,26,47,1,69,32,118,76,42,75,40,267,122,145,45,26,125,71,"1400-204"
"639",15,4,11,11,2,13,7,6,0,2,0,8,110,110,56,54,23,36,29,25,56,40,16,31,16,118,57,61,24,6,68,20,"1200-869"
"640",8,0,8,2,0,8,0,0,0,8,0,0,254,254,201,53,179,199,123,61,201,156,45,92,45,367,182,185,57,18,277,15,"1900-269"
"641",0,0,0,0,0,0,0,0,0,0,0,0,0,0,0,0,0,0,0,0,0,0,0,0,0,0,0,0,0,0,0,0,"1900-183"
"642",25,3,22,22,4,21,4,16,1,4,0,16,211,211,154,57,61,73,63,76,154,108,46,82,44,327,171,156,54,15,210,48,"1900-458"
"643",16,2,13,14,0,16,1,11,2,2,0,5,116,115,87,28,22,18,42,41,88,57,31,54,23,203,94,109,24,12,114,53,"1050-070"
"644",21,3,18,19,4,17,15,5,1,0,0,8,88,88,59,29,2,3,17,36,59,43,16,32,14,116,52,64,7,14,67,28,"1900-386"
"645",24,16,8,24,21,3,1,19,1,3,0,8,61,61,43,17,2,1,11,30,44,33,11,25,9,86,45,41,9,6,42,29,"1900-278"
"646",15,13,2,15,14,1,3,12,0,0,0,8,22,22,19,3,6,3,4,15,19,10,9,10,7,48,26,22,9,4,31,4,"1950-052"
"647",14,0,14,9,0,14,1,13,0,0,0,0,151,151,105,46,17,26,52,42,105,58,47,67,38,270,117,153,41,43,129,57,"1000-044"
"648",20,3,17,19,4,16,5,15,0,0,0,4,126,126,92,34,3,0,28,56,92,69,23,50,18,186,88,98,14,16,104,52,"1900-381"
"649",18,2,16,12,1,17,4,9,2,2,1,7,159,159,105,54,16,25,61,37,105,74,31,63,30,229,105,124,40,15,125,49,"1050-154"
"650",17,6,11,17,8,9,0,16,1,0,0,7,79,79,59,20,1,1,22,32,59,49,10,34,7,109,46,63,7,4,64,34,"1400-077"
"651",8,4,4,8,5,3,2,1,0,5,0,3,26,26,16,10,0,9,10,6,16,15,1,7,2,25,15,10,2,2,18,3,"1300-481"
"652",0,0,0,0,0,0,0,0,0,0,0,0,0,0,0,0,0,0,0,0,0,0,0,0,0,0,0,0,0,0,0,0,"1300-320"
"653",39,13,26,35,13,26,0,38,0,0,1,10,130,130,94,36,0,9,37,56,94,78,16,28,13,164,69,95,16,8,105,35,"1200-742"
"654",30,10,20,28,10,20,15,13,1,1,0,4,148,148,114,34,6,6,38,72,114,89,25,56,17,215,95,120,18,12,124,61,"1400-077"
"655",0,0,0,0,0,0,0,0,0,0,0,0,0,0,0,0,0,0,0,0,0,0,0,0,0,0,0,0,0,0,0,0,"1300-113"
"656",10,1,9,9,1,9,7,0,0,3,0,2,126,126,97,29,37,72,57,35,97,75,22,53,22,195,104,91,20,19,143,13,"1350-027"
"657",16,10,6,14,10,6,11,4,0,1,0,8,53,53,34,19,2,0,16,18,34,24,10,18,8,64,31,33,3,5,37,19,"1300-008"
"658",11,0,11,11,0,11,4,6,0,1,0,3,125,125,98,27,14,10,33,57,98,72,26,58,25,210,92,118,29,11,120,50,"1300-375"
"659",33,9,24,31,13,20,19,11,1,2,0,10,192,192,147,45,34,39,75,62,147,111,36,68,32,283,136,147,44,15,156,68,"1300-017"
"660",30,6,24,29,6,24,10,16,0,3,1,18,257,257,179,77,15,3,56,111,180,136,44,103,42,354,149,205,37,35,193,89,"1300-245"
"661",34,12,22,26,13,21,24,4,0,3,3,5,102,102,70,32,11,17,37,27,70,50,20,45,21,155,73,82,27,11,95,22,"1200-742"
"662",43,25,18,43,24,19,23,3,17,0,0,23,277,277,192,85,12,11,69,113,192,154,38,101,40,359,154,205,42,31,187,99,"1300-166"
"663",21,13,8,19,15,6,15,3,1,1,1,12,42,42,23,19,1,1,5,14,23,20,3,9,1,41,14,27,5,1,22,13,"1300-996"
"664",36,19,17,30,22,14,32,2,1,1,0,3,120,120,81,39,23,24,30,49,81,52,29,47,23,183,89,94,33,12,101,37,"1200-321"
"665",134,97,36,132,104,30,94,19,3,16,2,107,370,369,284,85,28,57,111,161,284,210,74,138,73,586,286,300,71,63,349,103,"1400-423"
"666",6,0,6,4,0,6,6,0,0,0,0,2,24,24,11,13,1,0,4,6,11,7,4,8,5,25,15,10,4,3,14,4,"1200-288"
"667",22,5,17,21,4,18,10,3,9,0,0,4,115,115,94,21,35,63,50,38,94,56,38,68,38,240,118,122,43,32,121,44,"1200-754"
"668",21,5,16,12,2,19,21,0,0,0,0,5,74,74,43,31,5,1,6,34,43,34,9,21,11,83,43,40,9,10,45,19,"1200-231"
"669",4,1,3,3,0,4,4,0,0,0,0,2,20,20,8,12,3,0,4,4,8,7,1,5,1,14,7,7,0,1,11,2,"1100-577"
"670",34,33,1,34,30,4,0,29,2,2,1,11,40,40,25,15,8,12,20,2,25,14,11,20,8,71,31,40,10,7,38,16,"1300-663"
"671",24,2,22,14,2,22,17,3,1,3,0,4,111,111,63,48,9,5,26,34,63,50,13,29,12,117,54,63,9,12,70,26,"1200-335"
"672",11,11,0,11,11,0,0,11,0,0,0,1,11,11,10,1,1,1,10,0,10,3,7,9,7,33,15,18,4,9,15,5,"1400-081"
"673",18,1,17,7,2,16,17,1,0,0,0,10,70,70,48,22,2,0,9,36,48,40,8,20,4,83,34,49,7,3,47,26,"1100-126"
"674",14,14,0,14,10,4,3,8,3,0,0,3,14,14,13,1,1,7,13,0,13,7,6,9,2,31,12,19,3,0,17,11,"1349-016"
"675",25,4,21,17,6,19,20,4,0,0,1,8,109,109,60,49,13,10,22,34,60,47,13,31,9,127,67,60,11,6,65,45,"1100-493"
"676",15,0,15,11,6,9,10,5,0,0,0,2,91,91,46,45,2,4,17,22,46,32,14,26,12,97,47,50,12,6,64,15,"1100-534"
"677",33,33,0,33,33,0,29,4,0,0,0,13,37,37,30,7,6,0,10,20,30,27,3,13,2,50,23,27,1,4,21,24,"1300-018"
"678",7,0,7,6,0,7,0,7,0,0,0,0,90,90,76,14,22,0,54,17,76,56,20,42,19,151,69,82,17,14,71,49,"1400-203"
"679",15,0,15,14,0,15,0,15,0,0,0,0,258,258,208,50,8,1,104,93,208,160,48,125,44,408,189,219,37,30,212,129,"1300-325"
"680",25,3,22,23,2,23,22,1,2,0,0,21,95,95,62,33,1,3,28,28,62,51,11,27,9,110,53,57,6,8,76,20,"1200-813"
"681",21,17,4,21,19,2,20,0,0,0,1,3,38,38,24,14,1,1,13,9,24,16,8,11,9,49,23,26,6,7,32,4,"1300-166"
"682",2,1,1,1,0,2,0,2,0,0,0,1,5,5,3,2,0,0,2,1,3,3,0,1,0,4,1,3,0,0,3,1,"1200-426"
"683",0,0,0,0,0,0,0,0,0,0,0,0,0,0,0,0,0,0,0,0,0,0,0,0,0,10,9,1,2,0,8,0,NA
"684",16,10,6,16,3,13,5,10,1,0,0,5,46,46,30,16,14,14,18,10,30,15,15,20,14,85,37,48,20,12,44,9,"1200-795"
"685",10,0,10,7,0,10,10,0,0,0,0,8,53,53,31,22,2,1,10,17,31,21,10,17,9,69,32,37,10,8,32,19,"1200-646"
"686",10,10,0,10,10,0,0,5,1,1,3,1,10,10,9,1,3,4,9,0,9,4,5,7,5,24,12,12,5,2,13,4,"1400-345"
"687",0,0,0,0,0,0,0,0,0,0,0,0,0,0,0,0,0,0,0,0,0,0,0,0,0,0,0,0,0,0,0,0,"1300-141"
"688",22,21,1,22,22,0,6,15,0,0,1,7,31,31,27,4,4,8,15,10,27,17,10,18,7,67,33,34,11,10,25,21,"1400-211"
"689",10,0,10,10,0,10,8,1,0,1,0,6,46,46,24,22,1,0,11,11,24,20,4,11,3,43,27,16,3,1,32,7,"1250-145"
"690",38,8,30,29,10,28,17,19,1,1,0,20,208,208,167,41,7,4,60,93,167,136,31,76,26,306,139,167,20,26,191,69,"1170-381"
"691",36,13,22,33,10,26,25,4,1,6,0,12,141,140,111,29,18,21,39,63,112,86,26,59,17,215,105,110,19,10,127,59,"1170-251"
"692",53,1,50,48,2,51,13,32,4,4,0,9,404,402,322,80,31,22,148,154,322,219,103,186,99,823,345,478,101,75,377,270,"1250-039"
"693",24,24,0,24,17,7,7,15,1,0,1,10,24,24,19,5,6,8,16,2,19,10,9,14,7,57,26,31,7,9,33,8,"1400-406"
"694",19,3,16,14,3,16,11,8,0,0,0,13,82,82,61,21,0,1,23,33,61,49,12,29,8,123,60,63,3,11,77,32,"1170-378"
"695",61,7,54,47,12,49,29,26,4,2,0,17,582,582,429,153,75,142,187,222,429,333,96,200,90,817,392,425,101,54,510,152,"1170-054"
"696",21,6,15,20,8,13,5,10,2,4,0,20,157,157,120,37,9,17,39,77,120,100,20,55,19,203,90,113,19,7,104,73,"1250-250"
"697",18,7,11,15,6,12,6,11,0,0,1,12,98,98,69,29,6,2,25,43,69,53,16,35,15,141,55,86,18,5,90,28,"1170-337"
"698",9,9,0,9,9,0,0,9,0,0,0,0,9,9,8,1,0,1,0,7,8,3,5,6,5,22,13,9,4,3,13,2,"1500-624"
"699",21,4,17,20,5,16,5,1,15,0,0,5,141,141,122,19,7,1,1,118,122,65,57,103,40,318,152,166,30,38,186,64,"1070-023"
"700",1,1,0,1,1,0,0,1,0,0,0,1,1,1,1,0,1,0,0,0,1,1,0,0,0,1,0,1,0,0,0,1,"1500-225"
"701",15,0,15,9,0,15,0,10,0,3,2,11,209,209,158,51,43,94,82,63,158,125,33,75,31,302,135,167,43,23,154,82,"1050-128"
"702",46,34,12,46,41,5,31,7,2,6,0,26,104,104,49,55,4,0,3,43,49,39,10,25,13,94,45,49,13,14,50,17,"1070-273"
"703",54,22,32,52,27,27,7,33,13,1,0,53,175,175,103,72,11,6,30,71,103,71,32,64,26,225,104,121,25,12,142,46,"1350-259"
"704",38,8,30,32,5,33,23,7,4,2,2,27,173,173,116,57,20,26,53,49,116,74,42,72,42,270,132,138,50,28,167,25,"1200-690"
"705",4,2,2,3,0,4,1,3,0,0,0,3,14,14,7,7,2,1,1,6,7,6,1,3,0,12,4,8,0,2,8,2,"1200-006"
"706",24,13,11,23,11,13,14,1,7,1,1,5,82,82,57,25,2,3,21,33,57,44,13,23,12,103,52,51,7,15,52,29,"1200-855"
"707",43,32,11,42,30,13,0,41,1,1,0,2,179,179,140,39,39,62,93,42,140,99,41,85,37,289,122,167,34,28,135,92,"1300-166"
"708",23,5,18,20,3,20,20,2,0,0,1,3,87,87,56,31,1,4,20,31,56,42,14,27,10,105,46,59,8,15,52,30,"1200-813"
"709",18,8,10,16,0,18,14,2,0,0,2,12,77,77,50,27,13,10,22,26,50,29,21,33,20,131,60,71,26,15,66,24,"1200-808"
"710",20,17,3,20,19,1,17,1,2,0,0,13,32,32,22,10,4,2,6,15,22,17,5,11,2,45,23,22,4,2,23,16,"1300-021"
"711",36,19,16,33,23,13,33,2,0,0,1,23,138,137,90,47,9,0,15,67,90,70,20,48,15,193,95,98,11,21,108,53,"1300-023"
"712",10,1,9,9,1,9,0,1,0,9,0,0,77,77,67,10,22,66,53,11,67,36,31,52,28,175,86,89,27,27,88,33,"1400-188"
"713",3,0,3,0,0,3,1,2,0,0,0,1,9,9,7,2,0,0,5,2,7,5,2,3,2,17,10,7,3,2,10,2,"1200-148"
"714",7,0,7,5,0,7,7,0,0,0,0,4,26,26,23,3,1,0,5,16,23,20,3,12,3,45,24,21,5,4,30,6,"1200-656"
"715",37,21,16,37,21,16,21,16,0,0,0,28,152,152,101,51,4,3,64,31,101,76,25,51,18,197,86,111,19,15,108,55,"1300-371"
"716",8,8,0,8,5,3,0,2,3,3,0,0,8,8,7,1,5,6,4,2,7,2,5,6,5,27,14,13,8,4,13,2,"1400-188"
"717",5,2,3,3,0,5,1,4,0,0,0,3,15,15,9,6,0,0,4,2,9,8,1,2,1,14,7,7,3,0,9,2,"1200-014"
"718",0,0,0,0,0,0,0,0,0,0,0,0,0,0,0,0,0,0,0,0,0,0,0,0,0,0,0,0,0,0,0,0,"1100-038"
"719",0,0,0,0,0,0,0,0,0,0,0,0,0,0,0,0,0,0,0,0,0,0,0,0,0,0,0,0,0,0,0,0,NA
"720",45,21,24,44,5,40,16,4,2,20,3,19,182,182,119,63,24,32,53,53,119,79,40,79,33,276,130,146,37,22,156,61,"1350-179"
"721",49,22,27,45,19,30,43,5,1,0,0,14,143,143,105,38,16,23,35,65,105,68,37,54,36,240,110,130,44,24,134,38,"1200-701"
"722",7,0,7,7,0,7,0,7,0,0,0,0,97,97,74,23,19,1,55,12,74,51,23,43,23,155,62,93,25,16,68,46,"1400-191"
"723",34,26,8,33,15,19,0,0,34,0,0,10,103,103,88,15,1,57,57,23,88,52,36,62,36,212,101,111,31,25,129,27,"1400-185"
"724",36,9,27,35,9,27,29,2,1,1,3,10,147,147,102,45,10,12,33,64,102,83,19,51,20,189,75,114,19,13,117,40,"1249-093"
"725",24,24,0,24,24,0,10,14,0,0,0,24,24,24,22,2,10,16,16,3,22,13,9,18,8,54,26,28,5,10,29,10,"1070-181"
"726",25,4,21,21,1,24,8,15,1,0,1,11,150,150,108,42,3,0,38,52,108,81,27,48,15,208,106,102,15,23,118,52,"1000-243"
"727",9,9,0,9,9,0,6,2,1,0,0,0,9,9,7,2,1,5,7,0,7,5,2,6,2,15,7,8,0,2,4,9,"1070-181"
"728",22,13,9,20,18,4,20,0,0,0,2,15,70,70,39,31,1,1,15,23,39,26,13,28,16,91,40,51,21,7,46,17,"1950-042"
"729",34,34,0,34,24,10,0,34,0,0,0,2,34,34,31,3,11,14,24,3,31,18,13,25,11,77,33,44,12,3,42,20,"1900-330"
"730",10,0,9,9,0,10,6,4,0,0,0,6,65,64,42,22,2,0,14,25,42,29,13,24,8,150,102,48,13,17,97,23,"1170-193"
"731",20,7,12,19,6,14,15,4,0,0,1,1,91,90,67,23,3,16,36,26,67,42,25,41,20,162,72,90,25,22,88,27,"1050-229"
"732",11,0,11,11,0,11,1,9,1,0,0,1,60,60,32,28,2,0,6,25,32,22,10,13,6,70,36,34,8,3,49,10,"1900-213"
"733",20,2,18,17,2,18,1,18,1,0,0,10,147,147,117,30,8,24,60,39,117,77,40,68,38,261,119,142,42,25,126,68,"1700-159"
"734",25,25,0,25,25,0,0,23,2,0,0,7,25,25,18,7,3,4,15,0,18,11,7,13,8,46,19,27,4,8,23,11,"1500-242"
"735",16,15,1,16,8,8,8,1,2,5,0,2,19,19,18,1,5,16,16,2,18,7,11,14,7,53,23,30,4,13,23,13,"1601-801"
"736",7,0,7,6,0,7,0,7,0,0,0,4,140,140,116,24,49,0,66,45,116,81,35,79,34,257,121,136,33,21,100,103,"1500-599"
"737",5,0,4,2,0,5,0,5,0,0,0,5,107,107,92,15,16,1,66,13,92,66,26,53,22,192,85,107,23,16,86,67,"1500-599"
"738",29,0,29,24,0,29,0,29,0,0,0,0,500,500,388,112,46,63,228,122,388,300,88,195,80,733,313,420,81,55,347,250,"1500-080"
"739",2,0,2,2,0,2,0,2,0,0,0,2,38,38,27,11,7,25,19,3,27,18,9,16,6,61,23,38,4,12,25,20,"1600-205"
"740",7,2,5,6,0,7,2,0,4,1,0,2,31,31,24,7,18,24,21,3,24,17,7,17,4,52,24,28,3,3,23,23,"1300-245"
"741",16,10,6,16,12,4,13,2,0,0,1,2,57,57,46,11,3,1,21,22,46,37,9,23,6,82,38,44,3,5,47,27,"1300-125"
"742",0,0,0,0,0,0,0,0,0,0,0,0,0,0,0,0,0,0,0,0,0,0,0,0,0,0,0,0,0,0,0,0,"1200-041"
"743",29,8,21,27,3,26,17,4,6,1,1,11,138,138,84,54,8,12,38,37,84,57,27,42,27,185,81,104,36,18,94,37,"1200-702"
"744",9,1,8,4,0,9,9,0,0,0,0,2,49,49,24,25,5,0,11,12,24,16,8,12,6,54,29,25,8,3,34,9,"1200-236"
"745",3,2,0,3,0,3,3,0,0,0,0,0,3,2,1,1,0,0,0,0,1,1,0,0,0,31,1,30,0,0,1,30,"1100-044"
"746",25,4,21,20,10,15,24,1,0,0,0,8,87,87,31,56,0,2,6,25,31,29,2,10,3,45,20,25,3,1,25,16,"1100-493"
"747",12,1,11,7,0,12,12,0,0,0,0,6,49,49,26,23,0,0,13,13,26,24,2,12,1,45,23,22,0,2,31,12,"1200-036"
"748",28,2,26,25,2,26,3,23,0,0,2,2,297,297,215,82,8,7,115,81,215,140,75,130,75,502,232,270,112,43,251,96,"1350-179"
"749",13,1,12,7,0,13,11,2,0,0,0,3,53,53,29,24,1,0,2,25,29,24,5,15,6,51,24,27,4,4,30,13,"1200-047"
"750",1,0,0,1,1,0,0,0,1,0,0,0,1,0,0,0,0,0,0,0,307,207,100,151,100,651,364,287,113,71,445,22,"1350"
"751",16,6,10,9,10,6,16,0,0,0,0,14,45,45,27,18,0,0,2,25,27,23,4,14,4,48,24,24,4,7,27,10,"1100-538"
"752",26,3,23,24,3,23,20,5,1,0,0,7,151,151,97,54,3,0,43,48,97,76,21,47,17,178,77,101,11,11,93,63,"1300-001"
"753",50,4,46,41,4,46,13,35,1,1,0,22,437,437,343,94,20,5,130,195,343,277,66,159,63,628,263,365,63,49,323,193,"1300-096"
"754",35,3,32,32,4,31,15,19,0,0,1,11,262,262,202,60,23,0,54,135,202,153,49,120,43,408,181,227,47,28,214,119,"1300-017"
"755",13,3,10,13,2,11,3,6,3,0,1,1,88,88,75,13,20,3,18,53,75,60,15,42,15,145,56,89,12,11,83,39,"1300-245"
"756",21,6,15,20,8,13,13,4,1,3,0,14,116,116,72,44,6,5,14,56,72,64,8,32,9,120,46,74,4,9,63,44,"1300-481"
"757",18,4,14,18,3,15,16,2,0,0,0,2,153,153,110,43,13,1,21,81,110,86,24,48,25,202,87,115,25,23,106,48,"1300-245"
"758",1,0,1,1,0,1,1,0,0,0,0,1,5,5,3,2,0,0,0,3,3,3,0,1,0,4,1,3,0,0,3,1,"1300-481"
"759",13,6,7,12,2,11,1,5,1,0,6,3,37,37,29,8,0,2,15,13,29,23,6,16,5,58,27,31,3,6,33,16,"1300-011"
"760",26,26,0,26,11,15,0,14,11,0,1,0,27,27,21,6,9,20,19,1,21,9,12,24,12,75,31,44,10,12,35,18,"1400-184"
"761",16,14,2,16,7,9,0,12,3,0,1,2,21,21,19,2,9,19,13,5,19,8,11,16,11,64,31,33,14,10,25,15,"1400-004"
"762",11,10,1,11,4,7,0,5,6,0,0,3,14,14,8,6,3,8,7,0,8,4,4,8,2,23,10,13,0,3,9,11,"1400-128"
"763",19,12,7,18,13,6,0,18,0,0,1,11,37,37,25,12,3,0,13,9,25,17,8,12,6,49,19,30,4,5,28,12,"1300-996"
"764",40,19,21,37,18,22,21,16,1,1,1,13,196,196,149,47,7,7,43,95,149,123,26,79,30,276,123,153,26,18,150,82,"1400-077"
"765",17,0,17,16,0,17,10,4,0,3,0,6,151,151,110,41,26,26,39,67,110,81,29,56,27,220,97,123,32,22,113,53,"1300-360"
"766",17,13,4,17,15,2,13,2,1,1,0,10,32,32,25,7,4,2,5,17,25,21,4,12,4,42,25,17,5,1,23,13,NA
"767",4,3,1,4,3,1,4,0,0,0,0,4,9,9,4,5,2,0,0,3,4,3,1,3,1,10,6,4,0,1,6,3,"1250-041"
"768",24,13,11,19,14,10,22,0,0,1,1,0,57,57,34,23,2,0,12,19,34,25,9,14,5,67,32,35,5,8,37,17,"1170-014"
"769",58,17,41,50,15,43,27,24,0,6,1,34,418,418,333,85,55,42,122,198,333,253,80,169,69,650,319,331,60,61,353,176,"1170-041"
"770",21,1,20,19,1,20,6,6,8,1,0,4,197,197,157,40,92,91,87,61,157,103,54,96,49,356,159,197,54,31,197,74,"1250-212"
"771",7,1,6,6,2,5,1,4,1,0,1,5,43,43,30,13,1,0,10,18,30,24,6,13,5,59,33,26,9,4,32,14,"1350-102"
"772",17,2,15,16,1,16,10,7,0,0,0,12,102,102,75,27,5,27,26,38,75,57,18,41,14,146,67,79,15,9,82,40,"1257-047"
"773",3,0,3,3,0,3,3,0,0,0,0,0,22,22,13,9,0,0,1,12,13,11,2,6,1,25,10,15,2,1,18,4,"1169-107"
"774",6,0,6,5,0,6,2,0,0,2,2,1,83,83,37,46,11,7,22,14,37,26,11,25,12,99,55,44,9,18,59,13,"1250-195"
"775",16,10,6,15,8,8,14,0,1,0,1,13,51,51,27,24,4,2,7,19,27,20,7,16,6,55,28,27,6,4,26,19,"1350-273"
"776",27,2,25,21,0,27,18,1,3,4,1,4,136,136,102,34,21,40,57,37,102,65,37,64,32,231,108,123,26,28,132,45,"1169-043"
"777",14,11,2,14,13,1,13,0,0,0,1,13,38,37,22,15,9,10,8,13,22,14,8,13,7,70,28,42,10,3,29,28,"1900-046"
"778",13,4,9,11,4,9,8,3,1,0,1,7,53,53,40,13,5,6,17,20,40,31,9,18,10,74,37,37,10,5,38,21,"1250-131"
"779",13,0,13,8,0,13,8,3,2,0,0,11,102,102,82,20,2,24,51,27,82,65,17,37,14,156,76,80,7,11,96,42,"1170-220"
"780",10,0,10,9,0,10,0,0,10,0,0,1,141,141,131,10,68,5,24,105,131,76,55,100,53,342,164,178,56,46,154,86,"1600-647"
"781",6,0,6,4,0,6,0,6,0,0,0,6,118,118,100,18,2,5,72,18,100,80,20,58,22,191,80,111,15,14,108,54,"1800-178"
"782",24,24,0,24,16,8,0,10,12,2,0,3,25,25,22,3,6,19,17,2,22,14,8,16,5,50,23,27,5,4,27,14,"1800-192"
"783",11,0,11,11,0,11,0,4,3,2,2,4,135,135,113,22,58,89,71,34,113,73,40,71,40,256,115,141,47,29,117,63,"1400-081"
"784",13,4,9,11,2,11,11,2,0,0,0,5,43,43,21,22,0,0,2,18,21,18,3,10,4,39,20,19,4,3,23,9,"1200-145"
"785",3,0,3,2,0,3,3,0,0,0,0,2,9,9,4,5,0,0,0,4,4,4,0,0,0,5,4,1,0,0,5,0,"1100-042"
"786",7,1,6,5,1,6,7,0,0,0,0,3,29,29,18,11,0,1,6,12,18,14,4,10,3,42,23,19,1,3,27,11,"1200-047"
"787",7,7,0,7,7,0,0,4,0,1,2,0,7,7,6,1,1,2,5,1,6,2,4,6,4,21,10,11,6,3,10,2,"1349-016"
"788",19,5,14,11,2,17,19,0,0,0,0,10,53,53,31,22,0,0,5,20,31,28,3,10,3,48,21,27,3,3,24,18,"1100-015"
"789",15,0,15,13,0,15,0,15,0,0,0,0,203,203,143,60,9,1,95,40,143,101,42,90,36,306,141,165,26,41,146,93,"1500-530"
"790",30,1,29,25,1,29,0,29,1,0,0,11,349,349,275,74,24,45,138,110,275,201,74,147,60,562,260,302,47,53,293,169,"1700-046"
"791",5,0,5,5,0,5,0,0,5,0,0,0,125,125,97,28,92,56,74,13,97,69,28,62,28,210,96,114,19,26,104,61,"1600-477"
"792",30,0,30,26,0,30,2,28,0,0,0,15,263,263,226,37,4,13,105,106,226,165,61,116,57,471,205,266,66,46,240,119,"1700-331"
"793",16,16,0,16,16,0,0,16,0,0,0,1,16,16,14,2,5,11,12,1,14,9,5,10,4,34,18,16,4,3,17,10,"1800-999"
"794",10,10,0,10,10,0,0,10,0,0,0,0,10,10,8,2,4,7,8,0,8,2,6,9,4,30,14,16,5,4,12,9,"1800-079"
"795",21,1,20,18,1,20,0,21,0,0,0,0,246,246,193,53,30,30,98,65,193,138,55,111,52,396,169,227,48,39,198,111,"1700-079"
"796",4,0,4,4,0,4,0,4,0,0,0,1,40,40,37,3,2,0,26,10,37,23,14,24,9,83,34,49,6,9,39,29,"1950-037"
"797",1,0,1,1,0,1,1,0,0,0,0,1,8,8,1,7,0,0,0,0,1,1,0,0,0,1,0,1,0,0,0,1,"1250-066"
"798",3,0,3,2,0,3,0,0,0,0,3,0,43,43,7,36,4,7,1,6,7,5,2,3,2,15,11,4,4,0,9,2,"1250-042"
"799",59,8,50,49,10,49,51,6,2,0,0,24,316,315,217,98,9,4,74,134,218,153,65,114,53,492,275,217,63,38,288,103,"1150-000"
"800",5,0,5,3,0,5,3,2,0,0,0,1,26,26,10,16,2,2,4,5,10,8,2,3,1,18,5,13,0,3,9,6,"1250-147"
"801",8,1,6,7,1,7,1,6,0,1,0,0,55,55,34,21,2,0,17,11,34,22,12,17,6,84,50,34,5,6,50,23,"1169-199"
"802",20,3,17,11,5,15,8,7,2,3,0,0,168,168,97,70,23,38,48,39,98,68,30,51,23,230,128,102,16,31,151,32,"1170-014"
"803",13,1,12,11,0,13,12,0,0,1,0,5,72,72,50,22,3,2,11,39,50,35,15,23,10,116,55,61,14,7,71,24,"1150-000"
"804",2,0,2,1,0,2,1,0,0,0,1,0,8,8,3,5,1,2,2,1,3,1,2,3,0,8,6,2,0,1,5,2,"1169-019"
"805",23,23,0,23,14,9,0,23,0,0,0,2,23,23,20,3,4,10,16,2,20,15,5,9,4,36,13,23,5,0,20,11,"1900-311"
"806",36,0,36,29,0,36,14,22,0,0,0,25,296,296,199,97,18,4,90,91,199,139,60,112,47,471,230,241,53,43,290,85,"1170-191"
"807",30,30,0,30,28,2,0,30,0,0,0,14,31,31,25,6,7,17,23,1,25,15,10,19,7,57,26,31,7,3,23,24,"1900-107"
"808",6,0,6,5,0,6,0,0,4,2,0,0,156,156,132,24,71,130,109,13,132,79,53,95,46,324,153,171,39,46,157,82,"1600-152"
"809",10,0,10,7,0,10,0,0,0,10,0,0,156,156,143,13,142,143,134,2,143,63,80,119,68,406,201,205,51,71,227,57,"1500-473"
"810",26,26,0,26,26,0,0,26,0,0,0,9,26,26,21,5,2,6,20,1,21,7,14,16,12,60,24,36,17,5,27,11,"1500-599"
"811",9,9,0,9,6,3,0,9,0,0,0,0,9,9,6,3,1,4,6,0,6,2,4,6,4,19,10,9,0,5,11,3,"1400-113"
"812",5,5,0,5,1,4,0,4,1,0,0,0,5,5,4,1,2,4,2,1,4,2,2,3,2,11,6,5,2,2,5,2,"1400-139"
"813",6,6,0,6,6,0,0,6,0,0,0,1,6,6,5,1,2,3,4,1,5,0,5,5,4,21,13,8,8,3,8,2,"1400-290"
"814",7,7,0,7,7,0,0,6,1,0,0,1,7,7,7,0,1,4,5,2,7,2,5,6,4,23,13,10,4,5,13,1,"1400-290"
"815",7,7,0,7,6,1,0,7,0,0,0,0,7,7,7,0,2,6,5,2,7,2,5,5,5,22,13,9,8,2,10,2,"1400-113"
"816",8,8,0,8,6,2,2,6,0,0,0,2,8,8,5,3,1,2,5,0,5,2,3,4,2,15,8,7,3,3,4,5,"1400-085"
"817",0,0,0,0,0,0,0,0,0,0,0,0,0,0,0,0,0,0,0,0,0,0,0,0,0,0,0,0,0,0,0,0,"1495-165"
"818",10,2,8,10,2,8,5,0,5,0,0,5,81,81,68,13,22,47,35,28,68,54,14,35,16,126,64,62,13,9,80,24,"1400-088"
"819",7,7,0,7,7,0,0,7,0,0,0,1,7,7,7,0,1,6,5,2,7,3,4,5,4,20,9,11,7,2,7,4,"1400-290"
"820",38,12,26,34,3,35,28,8,2,0,0,6,133,133,89,44,6,8,30,52,89,61,28,46,26,188,87,101,30,21,95,42,"1300-341"
"821",8,8,0,8,7,1,0,8,0,0,0,1,8,8,6,2,1,3,6,0,6,2,4,6,3,19,6,13,3,2,11,3,"1400-085"
"822",34,14,20,32,4,30,26,6,2,0,0,6,115,115,81,34,17,11,39,38,81,58,23,45,20,169,78,91,24,20,83,42,"1300-217"
"823",7,7,0,7,4,3,0,7,0,0,0,1,8,8,6,2,1,3,4,0,6,4,2,4,2,13,5,8,3,0,6,4,"1400-140"
"824",8,8,0,8,8,0,0,8,0,0,0,1,8,8,7,1,1,5,5,0,7,5,2,3,1,13,6,7,0,1,5,7,"1400-290"
"825",8,8,0,8,8,0,0,8,0,0,0,0,8,8,6,2,2,5,5,0,6,1,5,6,5,23,12,11,5,8,8,2,"1400-140"
"826",5,4,0,5,5,0,0,2,3,0,0,3,5,4,4,0,1,4,3,0,4,1,3,3,2,27,6,21,2,1,5,19,"1400-088"
"827",8,8,0,8,8,0,0,8,0,0,0,1,8,8,5,3,3,5,5,0,5,2,3,3,3,15,7,8,7,0,6,2,"1400-140"
"828",47,43,4,47,42,5,46,1,0,0,0,17,74,74,48,26,3,1,10,33,48,31,17,30,12,107,46,61,13,9,54,31,"1250-041"
"829",24,8,16,15,10,14,1,19,1,1,2,7,80,80,41,39,2,2,14,21,41,31,10,25,7,91,49,42,8,6,62,15,"1150-251"
"830",67,40,27,59,41,26,59,8,0,0,0,53,250,250,193,57,9,1,53,133,193,133,60,110,56,440,213,227,55,51,265,69,"1170-339"
"831",16,7,9,15,7,9,1,15,0,0,0,1,52,52,34,18,1,0,15,16,34,28,6,11,7,55,23,32,2,9,31,13,"1170-041"
"832",43,6,37,31,9,34,38,1,0,4,0,4,300,300,200,100,39,32,69,123,200,153,47,113,43,403,180,223,43,25,232,103,"1170-196"
"833",13,3,10,9,4,9,6,5,1,1,0,4,51,51,35,16,6,14,23,9,35,24,11,21,10,84,39,45,13,9,45,17,"1250-052"
"834",5,0,4,2,0,5,2,0,0,1,2,0,31,29,12,17,8,8,6,6,14,11,3,7,3,27,18,9,2,5,16,4,"1250-066"
"835",8,0,8,7,4,4,1,7,0,0,0,3,38,38,23,15,2,1,10,10,23,17,6,10,5,44,20,24,5,5,26,8,"1170-041"
"836",25,1,24,18,4,21,25,0,0,0,0,12,109,109,71,38,6,0,30,37,71,59,12,34,10,133,56,77,11,9,81,32,"1150-326"
"837",46,12,34,39,11,35,21,20,0,0,5,20,214,214,149,65,13,2,70,74,149,119,30,87,34,281,125,156,27,20,151,83,"1170-047"
"838",45,14,31,38,12,33,45,0,0,0,0,20,170,170,106,64,3,2,27,70,106,74,32,43,20,223,125,98,21,28,140,34,"1169-107"
"839",7,1,6,7,2,5,0,7,0,0,0,4,41,41,24,17,0,0,3,21,24,15,9,15,8,61,31,30,7,10,37,7,"1170-041"
"840",13,1,11,11,0,13,11,0,1,1,0,0,59,58,38,20,12,5,23,10,38,24,14,23,14,126,51,75,8,15,52,51,"1250-189"
"841",6,0,6,6,0,6,0,6,0,0,0,2,40,40,28,12,7,1,8,19,28,20,8,14,4,57,32,25,4,3,38,12,"1350-102"
"842",13,5,8,11,7,6,13,0,0,0,0,0,43,43,22,21,2,0,8,13,22,13,9,12,3,50,28,22,3,5,27,15,"1100-330"
"843",20,4,16,18,5,15,18,0,0,0,2,11,73,73,37,36,3,6,8,28,37,28,9,16,5,69,35,34,8,1,36,24,"1150-326"
"844",7,0,7,4,0,7,7,0,0,0,0,3,57,57,45,12,11,1,1,42,45,33,12,30,10,96,44,52,6,7,60,23,"1200-638"
"845",0,0,0,0,0,0,0,0,0,0,0,0,0,0,0,0,0,0,0,0,0,0,0,0,0,0,0,0,0,0,0,0,"1700-162"
"846",22,22,0,22,22,0,0,22,0,0,0,0,22,22,19,3,3,13,17,2,19,11,8,12,5,46,23,23,2,7,22,15,"1800-079"
"847",2,2,0,2,2,0,2,0,0,0,0,0,2,2,2,0,1,2,1,0,2,0,2,2,1,6,3,3,0,1,4,1,"1600-553"
"848",19,19,0,19,8,11,6,0,8,3,2,0,21,21,17,4,7,15,14,2,17,7,10,14,9,57,32,25,8,11,24,14,"1601-801"
"849",7,1,6,7,0,7,0,0,0,7,0,1,33,33,22,11,16,22,17,3,22,12,10,16,10,56,26,30,13,7,30,6,"1990-110"
"850",11,0,11,7,0,11,0,5,4,2,0,2,395,395,335,60,214,108,243,76,335,193,142,244,122,815,368,447,124,73,428,190,"1950-239"
"851",27,0,27,23,0,27,0,27,0,0,0,2,216,216,184,32,4,2,157,8,184,133,51,120,31,385,181,204,30,22,166,167,"1600-553"
"852",14,1,13,7,1,13,14,0,0,0,0,14,58,58,33,25,1,0,12,17,33,27,6,13,8,59,27,32,4,9,37,9,"1200-383"
"853",19,3,16,13,3,16,19,0,0,0,0,19,62,62,39,23,2,1,15,22,39,28,11,15,5,81,44,37,4,8,45,24,"1200-043"
"854",5,0,5,3,0,5,0,5,0,0,0,0,108,108,89,19,57,75,60,14,89,57,32,65,32,221,100,121,41,27,83,70,"1400-036"
"855",10,0,10,7,0,10,9,0,1,0,0,7,53,53,26,27,1,0,7,16,26,21,5,7,2,41,23,18,2,1,26,12,"1200-047"
"856",6,0,6,4,0,6,6,0,0,0,0,6,28,28,20,8,0,0,8,11,20,15,5,11,4,47,27,20,2,6,29,10,"1200-145"
"857",5,0,5,3,0,5,4,1,0,0,0,3,24,24,13,11,0,0,0,13,13,9,4,6,3,28,13,15,5,3,14,6,"1200-284"
"858",27,2,25,21,0,27,23,1,2,1,0,3,173,173,116,57,5,0,27,80,116,88,28,49,21,248,143,105,17,27,170,34,"1169-017"
"859",10,0,9,7,0,10,4,4,1,1,0,9,88,88,61,27,6,5,28,32,61,47,14,32,13,117,53,64,14,9,60,34,"1170-212"
"860",14,9,5,14,10,4,13,0,1,0,0,4,40,40,27,13,3,5,13,10,27,19,8,14,5,57,25,32,3,11,30,13,"1900-040"
"861",2,1,1,1,0,2,2,0,0,0,0,1,5,5,4,1,2,0,3,1,4,4,0,3,0,7,3,4,0,0,4,3,"1100-060"
"862",27,3,24,22,2,25,4,22,0,0,1,12,113,113,72,41,2,0,17,51,72,55,17,36,15,137,61,76,16,7,88,26,"1200-855"
"863",5,2,2,3,0,5,4,1,0,0,0,1,12,11,4,7,0,0,1,2,5,3,2,2,1,13,7,6,0,2,8,3,"1200-243"
"864",39,33,6,37,36,3,35,2,2,0,0,31,58,58,42,16,13,2,5,36,42,26,16,29,12,103,50,53,10,17,46,30,"1300-070"
"865",7,2,5,6,0,7,4,2,1,0,0,1,28,28,8,20,3,2,3,4,8,7,1,3,1,13,9,4,2,0,10,1,"1200-205"
"866",18,2,16,10,0,18,18,0,0,0,0,4,78,78,43,35,2,0,20,19,43,29,14,21,11,99,48,51,16,10,57,16,"1200-115"
"867",21,21,0,21,20,1,9,9,2,1,0,4,23,23,21,2,5,7,18,3,21,12,9,16,8,51,21,30,6,4,28,13,"1349-016"
"868",10,1,8,6,1,9,8,2,0,0,0,1,50,50,25,25,0,0,4,20,25,19,6,13,5,47,21,26,4,6,21,16,"1200-106"
"869",4,1,3,2,0,4,2,1,1,0,0,3,10,10,5,5,2,0,2,2,5,4,1,1,1,9,4,5,1,2,6,0,"1100"
"870",4,0,4,3,0,4,4,0,0,0,0,3,13,13,10,3,0,0,3,7,10,7,3,5,2,24,11,13,2,1,15,6,"1100-060"
"871",17,0,17,11,0,17,16,0,0,0,1,8,88,88,44,44,0,5,23,19,44,34,10,22,11,84,46,38,8,10,53,13,"1200-321"
"872",55,0,55,52,2,53,3,48,3,0,1,5,497,497,394,103,36,38,174,193,394,317,77,200,64,716,322,394,52,45,413,206,"1500-175"
"873",12,1,10,10,0,12,1,11,0,0,0,0,65,64,50,14,4,0,14,34,51,42,9,23,6,89,28,61,8,4,47,30,"1700-112"
"874",20,1,18,16,1,19,0,19,1,0,0,9,138,137,114,23,10,0,40,63,114,80,34,56,36,258,115,143,36,23,135,64,"1700-272"
"875",5,0,5,1,0,5,0,0,5,0,0,0,176,176,140,36,80,132,97,28,140,94,46,92,43,310,148,162,51,27,148,84,"1500-676"
"876",6,0,6,6,0,6,0,6,0,0,0,6,86,86,77,9,50,1,27,48,77,39,38,66,32,233,106,127,28,36,99,70,"1959-007"
"877",26,26,0,26,25,1,0,26,0,0,0,17,26,26,21,5,4,3,13,8,21,13,8,12,5,47,20,27,6,4,22,15,"1400-081"
"878",7,3,4,7,2,5,1,0,5,1,0,3,22,22,13,9,0,0,4,8,13,11,2,5,0,24,9,15,1,1,16,6,"1100-129"
"879",3,2,1,2,0,3,3,0,0,0,0,3,9,9,2,7,0,0,0,2,2,2,0,1,0,3,2,1,0,0,1,2,"1100-042"
"880",10,0,10,1,1,9,7,0,2,0,1,2,38,38,21,17,1,0,8,11,21,17,4,9,2,39,20,19,3,1,28,7,"1200-308"
"881",10,0,10,5,0,10,0,10,0,0,0,0,249,249,195,54,151,166,140,36,195,133,62,118,51,436,189,247,51,48,197,140,"1400-036"
"882",21,21,0,21,21,0,0,21,0,0,0,9,21,21,21,0,10,6,20,1,21,9,12,20,9,57,29,28,8,5,30,14,"1400-081"
"883",6,0,6,1,0,6,6,0,0,0,0,2,26,26,16,10,2,0,9,6,16,11,5,8,6,35,19,16,7,3,21,4,"1100-423"
"884",14,2,12,7,2,12,13,0,1,0,0,7,55,55,35,20,1,1,4,28,35,30,5,13,6,58,24,34,5,5,30,18,"1100-216"
"885",1,1,0,1,1,0,0,1,0,0,0,1,2,2,2,0,0,0,0,1,2,1,1,1,1,5,1,4,2,0,2,1,"1400-139"
"886",7,7,0,7,7,0,0,3,4,0,0,1,7,7,6,1,2,5,6,0,6,3,3,4,2,19,7,12,4,2,8,5,"1400-290"
"887",9,8,0,9,7,2,0,9,0,0,0,0,10,9,6,3,3,6,5,1,6,4,2,5,2,46,11,35,1,5,8,32,"1400-140"
"888",6,1,5,5,1,5,6,0,0,0,0,4,24,24,9,15,3,0,4,5,9,7,2,3,2,16,8,8,3,0,11,2,"1300-999"
"889",8,8,0,8,8,0,0,8,0,0,0,1,8,8,8,0,1,5,8,0,8,6,2,5,2,17,8,9,3,1,5,8,"1400-290"
"890",0,0,0,0,0,0,0,0,0,0,0,0,0,0,0,0,0,0,0,0,0,0,0,0,0,0,0,0,0,0,0,0,"1400-139"
"891",13,6,7,13,6,7,3,4,1,5,0,2,57,57,35,22,28,25,28,5,35,14,21,27,19,108,44,64,30,13,54,11,"1400-088"
"892",8,8,0,8,8,0,0,8,0,0,0,0,8,8,7,1,2,4,5,0,7,7,0,4,0,11,4,7,0,0,4,7,"1400-290"
"893",8,8,0,8,8,0,0,8,0,0,0,2,8,8,5,3,0,3,4,0,5,1,4,4,3,18,9,9,1,5,11,1,"1400-139"
"894",1,1,0,1,1,0,0,1,0,0,0,1,2,2,2,0,0,2,2,0,2,0,2,3,2,8,3,5,3,0,3,2,"1400-140"
"895",8,8,0,8,7,1,0,5,1,2,0,2,8,8,5,3,1,3,5,0,5,1,4,6,4,18,8,10,7,0,10,1,"1400-139"
"896",2,2,0,2,2,0,0,2,0,0,0,2,4,4,4,0,0,1,1,3,4,4,0,1,0,5,2,3,0,0,3,2,"1400-139"
"897",8,8,0,8,6,2,0,8,0,0,0,1,8,8,4,4,1,2,3,0,4,2,2,4,3,16,8,8,3,4,7,2,"1400"
"898",8,8,0,8,7,1,0,7,0,1,0,1,8,8,6,2,2,4,5,1,6,2,4,6,4,23,12,11,4,6,8,5,"1400-139"
"899",8,8,0,8,5,3,0,8,0,0,0,0,8,8,7,1,2,4,6,0,7,5,2,7,2,19,10,9,2,3,9,5,"1400"
"900",14,7,7,14,5,9,1,1,2,10,0,2,40,40,40,0,18,4,8,30,40,20,20,32,16,109,51,58,18,14,53,24,"1349-016"
"901",8,1,7,5,0,8,7,0,1,0,0,1,26,26,20,6,0,0,6,13,20,19,1,6,1,31,13,18,3,1,13,14,"1200-106"
"902",16,1,15,10,2,14,16,0,0,0,0,15,50,50,42,8,2,0,5,34,42,30,12,19,9,79,41,38,9,9,48,13,"1100-542"
"903",59,39,20,59,54,5,28,30,0,0,1,6,157,157,112,45,10,1,38,70,112,86,26,58,22,214,107,107,22,19,120,53,"1300-125"
"904",1,1,0,1,0,1,1,0,0,0,0,0,1,1,0,1,0,0,0,0,0,0,0,0,0,0,0,0,0,0,0,0,"1100-054"
"905",47,47,0,47,47,0,1,42,1,2,1,6,47,47,37,10,5,7,30,5,37,17,20,33,16,99,48,51,15,7,62,15,"1400-081"
"906",12,4,8,12,3,9,0,6,6,0,0,8,64,64,58,6,2,5,34,21,58,36,22,36,16,145,69,76,19,15,73,38,"1349-016"
"907",4,0,4,2,0,4,4,0,0,0,0,2,24,24,14,10,5,1,2,11,14,9,5,10,4,30,18,12,2,3,20,5,"1200-270"
"908",54,23,31,52,26,28,34,15,2,3,0,38,319,319,239,79,42,27,111,112,240,177,63,135,55,507,227,280,53,57,276,121,"1350-251"
"909",5,0,5,2,0,5,5,0,0,0,0,3,26,26,11,15,0,0,3,7,11,8,3,2,1,20,13,7,0,3,11,6,"1200-285"
"910",4,0,3,2,2,2,1,3,0,0,0,1,19,19,11,8,0,0,1,10,11,10,1,3,1,17,8,9,1,0,9,7,"1100-340"
"911",0,0,0,0,0,0,0,0,0,0,0,0,0,0,0,0,0,0,0,0,0,0,0,0,0,0,0,0,0,0,0,0,"1100-278"
"912",31,30,1,31,30,1,0,27,1,3,0,10,33,33,31,2,6,7,26,3,31,18,13,20,12,74,35,39,10,6,48,10,"1400-081"
"913",6,6,0,6,6,0,0,6,0,0,0,1,6,6,5,1,0,0,4,0,5,3,2,4,2,14,8,6,2,3,9,0,"1400-081"
"914",4,1,3,4,0,4,4,0,0,0,0,1,25,25,16,9,0,1,0,16,16,10,6,5,3,48,42,6,3,2,42,1,"1100-054"
"915",49,19,30,36,20,29,44,4,0,1,0,3,148,148,87,61,2,0,14,67,87,76,11,36,9,146,72,74,11,11,93,31,"1100-615"
"916",3,2,1,2,1,2,2,0,1,0,0,2,4,4,4,0,1,1,2,1,4,4,0,1,0,5,2,3,0,0,3,2,"1200-284"
"917",16,3,13,15,0,16,3,10,2,1,0,2,87,87,57,30,3,5,14,37,57,43,14,37,13,123,48,75,14,6,64,39,"1350-251"
"918",37,37,0,37,37,0,0,25,6,4,2,5,37,37,28,9,4,8,25,1,28,17,11,21,8,71,34,37,11,5,37,18,"1400-081"
"919",5,1,4,4,0,5,5,0,0,0,0,5,16,16,6,10,0,0,3,3,6,5,1,4,1,12,4,8,0,1,2,9,"1200-047"
"920",21,5,16,12,1,20,18,2,1,0,0,10,82,82,45,37,3,1,15,26,45,32,13,26,12,95,39,56,7,14,44,30,"1200-156"
"921",51,14,37,46,11,40,39,5,0,0,7,33,239,239,175,64,28,56,79,75,175,116,59,99,52,400,174,226,53,54,197,96,"1200-612"
"922",8,1,7,5,1,7,8,0,0,0,0,1,36,36,18,18,0,0,3,13,18,11,7,8,2,41,22,19,4,2,26,9,"1100-177"
"923",44,15,29,33,12,32,43,1,0,0,0,0,125,125,75,50,1,0,18,52,75,66,9,23,6,112,58,54,7,3,75,27,"1100-081"
"924",3,1,2,3,0,3,1,2,0,0,0,0,12,12,4,8,1,2,3,1,4,4,0,2,0,6,4,2,0,0,5,1,"1200-466"
"925",15,1,14,6,1,14,15,0,0,0,0,11,71,71,41,30,5,1,4,36,41,38,3,18,5,65,31,34,2,5,34,24,"1100-411"
"926",1,0,1,0,1,0,1,0,0,0,0,1,2,2,2,0,0,0,0,2,2,1,1,1,0,4,1,3,0,0,3,1,"1100-126"
"927",26,26,0,26,26,0,0,24,1,0,1,2,26,26,21,5,3,3,19,0,21,15,6,15,6,44,20,24,4,5,24,11,"1400-081"
"928",10,3,7,8,2,8,2,5,2,1,0,7,50,50,30,20,7,11,11,17,30,26,4,13,2,50,24,26,4,1,30,15,"1250-106"
"929",30,5,25,24,4,26,18,11,0,1,0,13,178,178,142,36,8,0,33,102,142,105,37,73,30,304,133,171,32,21,170,81,"1150-000"
"930",11,5,6,10,5,6,0,9,1,1,0,6,42,42,33,9,3,4,17,15,33,21,12,15,8,76,43,33,10,4,45,17,"1170-166"
"931",8,1,7,3,0,8,8,0,0,0,0,4,26,26,16,10,0,0,5,9,16,12,4,9,4,37,14,23,4,3,17,13,"1200-211"
"932",14,4,10,9,3,11,0,0,10,4,0,9,41,41,26,15,1,1,2,22,26,24,2,9,3,38,18,20,1,2,20,15,"1100-245"
"933",13,2,10,7,0,13,13,0,0,0,0,6,53,52,35,17,1,0,11,17,36,25,11,17,7,73,36,37,9,3,47,14,"1200-309"
"934",22,13,9,15,14,8,1,1,16,3,1,7,47,47,33,14,4,0,4,28,33,28,5,15,3,60,33,27,2,2,42,14,"1100-213"
"935",10,0,10,9,0,10,0,0,10,0,0,4,247,247,221,26,143,50,2,208,221,141,80,145,72,519,246,273,84,59,258,118,"1300-125"
"936",9,1,8,4,1,8,6,2,0,0,1,2,42,42,34,8,2,0,5,28,34,32,2,10,3,47,21,26,1,2,33,11,"1100-515"
"937",10,0,10,9,0,10,0,10,0,0,0,0,200,200,149,51,85,136,101,30,149,106,43,84,42,317,157,160,55,30,149,83,"1400-195"
"938",18,0,18,14,0,18,18,0,0,0,0,13,74,74,33,41,0,1,14,18,33,27,6,14,5,60,32,28,4,3,44,9,"1200-249"
"939",61,33,28,57,34,27,38,23,0,0,0,59,317,317,242,75,27,5,89,139,242,184,58,114,57,468,208,260,50,41,245,132,"1350"
"940",21,4,16,9,0,21,20,0,0,0,1,9,92,91,50,41,2,1,15,31,51,35,16,27,16,116,64,52,13,13,73,17,"1200-158"
"941",12,1,11,6,0,12,11,1,0,0,0,8,50,50,32,18,2,1,13,17,32,25,7,15,3,63,38,25,3,2,48,10,"1200-158"
"942",18,2,16,14,1,17,16,1,0,1,0,16,69,69,38,31,0,0,7,30,38,29,9,18,7,81,42,39,10,6,47,18,"1200-043"
"943",2,1,1,2,0,2,2,0,0,0,0,2,5,5,1,4,0,0,1,0,1,1,0,0,0,1,0,1,0,0,1,0,"1100-232"
"944",9,3,6,7,3,6,6,3,0,0,0,5,32,32,15,17,1,0,2,9,15,12,3,4,1,25,13,12,2,0,15,8,"1100-004"
"945",38,13,24,25,10,28,36,1,0,1,0,4,131,130,80,50,9,11,21,51,80,62,18,35,15,151,73,78,14,8,87,42,"1249-027"
"946",8,2,6,4,1,7,8,0,0,0,0,1,25,25,11,14,2,0,0,11,11,11,0,0,0,11,4,7,0,0,9,2,"1100-081"
"947",2,1,1,1,1,1,2,0,0,0,0,1,9,9,3,6,0,0,0,3,3,3,0,0,0,4,2,2,0,0,2,2,"1200-470"
"948",16,3,11,9,2,14,11,0,4,0,1,10,75,73,29,44,7,3,14,13,38,30,8,14,7,70,39,31,6,8,39,17,"1200-092"
"949",1,0,1,1,0,1,1,0,0,0,0,0,3,3,3,0,1,0,1,1,3,2,1,2,1,6,3,3,0,1,5,0,"1149-039"
"950",41,41,0,41,41,0,0,38,0,1,2,6,41,41,33,8,8,6,29,3,33,21,12,24,10,75,36,39,7,8,30,30,"1400-081"
"951",25,25,0,25,25,0,3,21,0,1,0,1,25,25,23,2,8,1,19,1,23,11,12,18,9,63,25,38,10,4,27,22,"1400-081"
"952",0,0,0,0,0,0,0,0,0,0,0,0,0,0,0,0,0,0,0,0,0,0,0,0,0,0,0,0,0,0,0,0,"1150-010"
"953",5,0,4,4,1,4,5,0,0,0,0,2,30,29,14,15,1,1,9,3,14,6,8,9,4,58,46,12,3,6,35,14,"1170-217"
"954",24,2,22,23,23,1,24,0,0,0,0,15,90,90,68,22,18,13,55,8,68,47,21,36,19,144,66,78,19,15,85,25,"1170-998"
"955",23,2,21,20,2,21,21,1,0,1,0,8,117,117,75,42,5,0,29,41,75,56,19,32,14,163,98,65,12,17,110,24,"1150-034"
"956",18,4,14,13,5,13,1,14,0,0,3,9,85,85,59,26,10,2,23,34,59,51,8,30,9,104,41,63,9,4,51,40,"1300-402"
"957",31,3,28,29,9,22,24,5,0,1,1,9,151,151,104,47,3,5,49,51,104,83,21,54,19,196,88,108,17,13,123,43,"1300-017"
"958",13,0,13,13,0,13,6,6,1,0,0,2,106,106,66,40,5,4,11,50,66,56,10,26,11,111,47,64,6,11,65,29,"1300-375"
"959",8,7,1,8,7,1,8,0,0,0,0,4,20,20,12,8,0,0,7,3,12,8,4,8,4,26,12,14,1,6,7,12,"1300-104"
"960",13,7,6,11,8,5,9,4,0,0,0,7,44,44,36,8,5,0,14,18,36,31,5,20,4,62,29,33,3,4,38,17,"1400-077"
"961",51,27,24,49,27,24,6,45,0,0,0,16,334,334,264,70,40,37,115,133,264,185,79,160,69,559,238,321,65,47,270,177,"1349-002"
"962",13,0,13,11,0,13,0,13,0,0,0,10,117,117,93,24,11,8,35,45,93,75,18,46,19,181,76,105,30,13,83,55,"1349-049"
"963",21,18,3,19,20,1,19,1,0,1,0,13,34,34,19,15,4,0,5,10,19,13,6,14,6,40,21,19,6,2,20,12,"1300-996"
"964",11,6,5,10,7,4,5,4,1,0,1,0,25,25,21,4,4,1,6,13,21,15,6,13,6,47,26,21,7,5,26,9,"1300-996"
"965",54,46,8,52,47,7,37,16,1,0,0,52,86,86,46,40,4,0,16,27,46,36,10,25,8,88,45,43,11,4,53,20,"1350-261"
"966",14,11,2,14,12,2,7,7,0,0,0,4,23,22,17,5,5,2,5,10,17,9,8,10,7,54,26,28,12,12,24,6,"1300-320"
"967",31,21,10,31,20,11,19,11,0,1,0,30,69,69,50,19,1,1,10,34,50,40,10,28,9,100,51,49,7,9,60,24,"1350-154"
"968",24,1,23,21,3,21,19,5,0,0,0,10,134,134,87,47,0,2,39,46,87,57,30,51,29,198,87,111,29,24,104,41,"1300-366"
"969",8,0,8,4,0,8,6,0,1,0,1,6,48,48,45,3,2,0,25,20,45,30,15,23,14,100,40,60,17,11,62,10,"1300-328"
"970",6,6,0,6,6,0,6,0,0,0,0,6,9,9,6,3,0,0,0,6,6,4,2,2,1,11,5,6,2,0,5,4,"1350-027"
"971",23,8,15,19,7,16,6,17,0,0,0,19,89,89,66,23,4,4,20,40,66,50,16,30,17,131,57,74,16,17,64,34,"1350-278"
"972",57,8,49,56,27,30,27,23,0,0,7,37,437,437,281,155,22,19,84,175,282,224,58,129,47,528,236,292,46,41,288,153,"1300-325"
"973",27,15,12,24,14,13,22,5,0,0,0,12,62,62,35,27,3,7,12,22,35,25,10,23,9,78,39,39,13,7,41,17,"1200-742"
"974",19,3,16,17,0,19,0,17,2,0,0,12,160,160,121,39,7,27,67,47,121,91,30,64,32,235,102,133,27,22,129,57,"1349-049"
"975",39,7,32,35,6,33,2,36,1,0,0,32,270,270,218,52,14,12,76,125,218,167,51,123,51,439,188,251,66,28,217,128,"1300"
"976",59,35,24,58,36,23,50,6,0,3,0,8,304,304,236,68,85,61,94,133,236,165,71,134,66,498,243,255,70,41,275,112,"1300-166"
"977",13,13,0,13,8,5,0,11,0,1,1,4,13,13,7,6,2,7,7,0,7,6,1,5,1,17,6,11,3,1,5,8,"1400-297"
"978",22,15,7,22,11,11,16,6,0,0,0,2,44,44,33,11,2,7,16,15,33,23,10,18,11,73,33,40,6,12,42,13,"1350-070"
"979",33,33,0,33,12,21,0,29,0,4,0,5,33,33,24,9,9,21,20,2,24,13,11,18,8,69,35,34,14,7,31,17,"1400-315"
"980",4,0,4,3,0,4,0,4,0,0,0,0,52,52,41,11,20,0,32,6,41,33,8,19,7,76,28,48,11,3,36,26,"1400-191"
"981",21,1,20,21,1,20,8,12,0,0,1,13,187,187,141,46,7,0,59,72,141,111,30,74,30,262,106,156,25,18,154,65,"1300-546"
"982",30,28,2,30,15,15,0,30,0,0,0,0,55,55,46,9,14,21,35,6,46,38,8,27,9,91,38,53,13,5,27,46,"1400-294"
"983",12,2,9,10,1,11,8,1,1,2,0,6,89,88,59,29,16,23,33,19,61,41,20,34,18,144,62,82,12,27,76,29,"1050-058"
"984",39,1,38,30,0,39,25,13,0,1,0,9,341,341,224,117,24,17,110,92,224,149,75,128,64,500,221,279,75,46,272,107,"1000-268"
"985",18,18,0,18,18,0,0,17,0,1,0,18,18,18,18,0,2,0,1,17,18,14,4,11,7,38,17,21,3,5,20,10,"1500-462"
"986",6,1,5,6,6,0,1,5,0,0,0,6,61,61,50,11,6,1,16,3,50,19,31,43,28,159,85,74,41,19,76,23,"1900-240"
"987",11,0,11,9,0,11,0,4,7,0,0,6,297,297,248,49,40,2,39,187,248,172,76,157,67,527,241,286,56,54,258,159,"1900-330"
"988",14,0,14,13,1,13,6,7,0,1,0,10,68,68,48,20,4,0,9,33,48,31,17,31,13,113,55,58,16,4,62,31,"1900-381"
"989",7,2,5,7,0,7,2,3,0,2,0,0,64,64,51,13,14,21,26,22,51,31,20,35,18,121,60,61,24,4,65,28,"1050-186"
"990",11,0,11,11,0,11,0,0,8,0,3,5,266,266,245,21,128,4,7,234,245,121,124,219,122,754,356,398,136,109,361,148,"1500-534"
"991",13,0,13,13,0,13,0,0,0,13,0,13,191,191,159,32,58,5,1,154,159,93,66,107,46,408,195,213,72,36,208,92,"1900-240"
"992",4,1,3,4,0,4,0,4,0,0,0,1,16,16,8,8,1,0,1,7,8,6,2,4,1,16,9,7,2,0,12,2,NA
"993",23,5,18,21,4,19,13,7,3,0,0,8,104,104,73,31,16,25,38,29,73,50,23,49,22,171,78,93,29,14,84,44,"1200-843"
"994",4,0,4,3,0,4,0,4,0,0,0,0,28,28,1,27,0,0,0,1,1,0,1,1,1,4,1,3,0,1,3,0,"1200-478"
"995",7,0,7,6,0,7,0,7,0,0,0,0,74,74,53,21,16,12,25,23,53,35,18,32,14,119,56,63,17,8,60,34,"1400-225"
"996",27,26,1,27,25,2,19,8,0,0,0,24,35,35,22,13,4,0,2,18,22,14,8,11,7,44,20,24,7,5,24,8,"1070"
"997",14,14,0,14,14,0,10,4,0,0,0,5,14,14,11,3,2,5,10,0,11,6,5,9,4,31,16,15,4,5,11,11,"1070-181"
"998",16,2,14,16,0,16,10,4,2,0,0,2,129,129,89,40,13,14,51,33,89,62,27,52,19,192,93,99,25,16,103,48,"1050-000"
"999",16,7,8,15,9,7,0,14,1,1,0,14,83,82,60,22,2,0,1,58,60,48,12,27,13,148,54,94,10,12,52,74,"1099-035"
"1000",50,50,0,50,50,0,0,50,0,0,0,23,50,50,45,5,11,29,38,3,45,28,17,29,16,101,45,56,13,12,50,26,"1900-107"
"1001",4,2,2,4,2,2,2,1,1,0,0,2,15,15,8,7,2,2,1,2,8,5,3,5,3,18,11,7,4,1,10,3,"1070-124"
"1002",13,13,0,13,13,0,11,0,1,0,1,4,13,13,9,4,3,9,9,0,9,5,4,9,3,24,12,12,0,3,14,7,"1070-181"
"1003",0,0,0,0,0,0,0,0,0,0,0,0,0,0,0,0,0,0,0,0,0,0,0,0,0,0,0,0,0,0,0,0,"1069-089"
"1004",44,4,39,40,4,40,25,19,0,0,0,2,367,366,288,78,17,42,142,120,288,195,93,167,74,703,369,334,71,95,399,138,"1900-998"
"1005",38,2,36,36,4,34,22,15,1,0,0,22,237,237,177,59,4,20,74,83,178,141,37,80,24,348,164,184,23,24,232,69,"1000-101"
"1006",8,8,0,8,8,0,6,2,0,0,0,2,8,8,6,2,5,6,5,1,6,5,1,3,2,11,5,6,3,0,5,3,"1070-181"
"1007",17,0,17,10,0,17,15,2,0,0,0,10,119,119,70,49,5,0,24,40,70,48,22,33,10,153,80,73,10,12,97,34,"1170-193"
"1008",7,3,4,6,3,4,0,7,0,0,0,5,80,80,68,12,4,1,4,62,68,32,36,56,33,189,86,103,29,26,96,38,"1400-061"
"1009",63,61,2,63,62,1,42,21,0,0,0,59,80,80,50,30,10,6,7,36,50,31,19,27,21,107,49,58,20,16,53,18,"1070-181"
"1010",55,55,0,55,55,0,0,52,3,0,0,55,55,55,50,5,9,3,1,48,50,31,19,40,21,125,57,68,16,14,58,37,"1500-663"
"1011",0,0,0,0,0,0,0,0,0,0,0,0,0,0,0,0,0,0,0,0,0,0,0,0,0,0,0,0,0,0,0,0,"1350-154"
"1012",24,24,0,24,2,22,0,20,3,1,0,3,25,25,20,5,13,17,16,4,20,12,8,17,6,50,28,22,7,4,20,19,"1400-293"
"1013",7,0,7,4,0,7,7,0,0,0,0,1,28,28,24,4,0,0,16,6,24,16,8,15,8,52,24,28,6,3,31,12,"1300-017"
"1014",10,0,10,9,1,9,10,0,0,0,0,3,48,48,34,14,0,0,21,13,34,28,6,19,5,65,30,35,8,0,34,23,"1300-104"
"1015",10,0,10,8,3,7,10,0,0,0,0,1,43,43,22,21,1,0,14,7,22,14,8,15,7,52,22,30,11,5,27,9,"1300-104"
"1016",6,5,1,6,2,4,0,6,0,0,0,3,8,8,7,1,4,6,6,0,7,6,1,4,1,13,5,8,2,0,7,4,"1400-149"
"1017",23,23,0,23,23,0,1,18,1,3,0,6,23,23,19,4,3,6,18,1,19,11,8,16,8,53,20,33,8,8,22,15,"1400-081"
"1018",15,6,9,14,3,12,10,5,0,0,0,8,54,54,41,13,7,8,18,18,41,25,16,27,14,101,43,58,14,15,49,23,"1250-096"
"1019",22,4,18,20,3,19,0,21,0,1,0,10,100,100,70,30,3,1,39,27,70,54,16,32,14,133,58,75,15,9,72,37,"1600-093"
"1020",0,0,0,0,0,0,0,0,0,0,0,0,0,0,0,0,0,0,0,0,0,0,0,0,0,0,0,0,0,0,0,0,"1000-081"
"1021",23,0,23,15,0,23,0,23,0,0,0,4,209,209,144,65,7,2,75,56,144,102,42,78,43,305,140,165,54,31,164,56,"1000"
"1022",14,0,14,11,0,14,0,0,14,0,0,9,270,270,201,69,135,51,151,30,201,138,63,122,49,455,210,245,42,48,249,116,"1900-916"
"1023",2,2,0,2,2,0,1,1,0,0,0,2,2,2,1,1,0,0,1,0,1,1,0,0,0,1,0,1,0,0,0,1,"1950-128"
"1024",0,0,0,0,0,0,0,0,0,0,0,0,0,0,0,0,0,0,0,0,0,0,0,0,0,0,0,0,0,0,0,0,"1950-408"
"1025",6,0,6,5,0,6,0,0,0,6,0,0,190,190,138,52,121,136,68,51,138,107,31,58,32,252,123,129,44,14,184,10,"1600-251"
"1026",10,0,10,9,0,10,0,10,0,0,0,5,62,62,48,14,1,0,37,7,48,36,12,29,10,100,54,46,9,10,45,36,"1700"
"1027",32,32,0,32,7,25,0,32,0,0,0,14,32,32,25,7,11,23,19,4,25,10,15,21,11,81,35,46,15,8,38,20,"1700-194"
"1028",15,1,14,14,1,14,0,15,0,0,0,9,184,184,146,38,20,1,91,35,146,121,25,72,23,269,110,159,24,12,143,90,"1500-110"
"1029",5,0,5,4,0,5,0,5,0,0,0,3,122,122,110,12,42,0,65,38,110,72,38,81,29,261,117,144,29,21,118,93,"1950-244"
"1030",45,1,44,40,1,44,0,40,4,0,1,36,438,438,337,101,29,41,136,177,337,264,73,190,63,660,296,364,56,41,386,177,"1500-002"
"1031",17,0,17,15,0,17,0,17,0,0,0,3,106,106,89,17,2,16,48,29,89,63,26,51,19,183,85,98,20,14,101,48,"1700-996"
"1032",15,0,15,14,0,15,0,0,0,15,0,0,255,255,233,22,215,233,195,23,233,94,139,184,128,648,325,323,98,124,365,61,"1500-359"
"1033",30,28,2,29,10,20,0,28,0,2,0,1,57,57,47,10,29,34,38,6,47,33,14,33,12,101,45,56,11,11,37,42,"1700-135"
"1034",20,1,19,20,1,19,1,12,0,6,1,3,269,269,213,56,88,93,168,30,213,141,72,138,67,468,211,257,65,41,242,120,"1500-592"
"1035",13,9,4,13,9,4,10,2,0,0,1,5,39,39,30,9,6,13,18,12,30,22,8,22,6,63,33,30,1,9,27,26,"1849-001"
"1036",5,0,5,3,0,5,0,2,3,0,0,0,116,116,108,8,66,4,58,48,108,53,55,95,47,301,141,160,44,37,159,61,"1950-134"
"1037",13,13,0,12,12,1,11,1,1,0,0,10,14,14,8,6,0,2,3,5,8,6,2,6,2,17,4,13,1,2,2,12,"1849-001"
"1038",31,0,31,23,0,31,0,31,0,0,0,12,199,199,152,47,8,5,104,36,152,114,38,77,42,300,126,174,50,20,170,60,"1700-013"
"1039",34,28,6,33,29,5,27,6,0,1,0,21,88,88,66,22,3,1,34,30,66,50,16,29,11,120,58,62,12,5,62,41,"1300-481"
"1040",46,30,15,39,40,6,44,2,0,0,0,33,107,106,66,40,5,0,25,35,66,59,7,21,8,140,82,58,9,12,101,18,"1300-141"
"1041",10,0,10,9,1,9,10,0,0,0,0,1,51,51,38,13,0,0,22,13,38,30,8,16,8,74,41,33,8,4,45,17,"1300-104"
"1042",23,17,6,19,17,6,15,5,0,0,3,15,45,45,31,14,5,1,12,15,31,22,9,12,7,57,28,29,10,1,36,10,"1300-146"
"1043",47,22,24,43,19,28,24,18,1,0,4,17,162,161,99,62,7,11,28,66,99,72,27,57,27,220,98,122,36,23,113,48,"1200-745"
"1044",12,2,10,11,2,10,2,10,0,0,0,1,59,59,45,14,4,1,18,25,45,37,8,17,7,77,37,40,5,4,45,23,"1400-077"
"1045",15,1,14,10,4,11,11,2,1,1,0,3,142,142,117,25,49,35,70,41,117,85,32,71,32,250,105,145,34,23,120,73,"1300-375"
"1046",43,32,8,40,34,9,24,9,3,3,4,13,175,173,142,31,83,110,80,44,143,89,54,92,59,347,163,184,72,36,204,35,"1600-177"
"1047",0,0,0,0,0,0,0,0,0,0,0,0,0,0,0,0,0,0,0,0,0,0,0,0,0,0,0,0,0,0,0,0,"1600"
"1048",53,53,0,53,53,0,0,53,0,0,0,9,53,53,45,8,10,9,41,0,45,21,24,39,23,129,61,68,25,16,60,28,"1500-599"
"1049",0,0,0,0,0,0,0,0,0,0,0,0,0,0,0,0,0,0,0,0,0,0,0,0,0,0,0,0,0,0,0,0,"1950-133"
"1050",4,0,4,3,0,4,0,0,0,4,0,0,207,207,163,44,142,159,111,45,163,95,68,112,72,398,185,213,79,35,264,20,"1950-392"
"1051",0,0,0,0,0,0,0,0,0,0,0,0,0,0,0,0,0,0,0,0,0,0,0,0,0,0,0,0,0,0,0,0,"1649-035"
"1052",16,1,11,12,0,16,0,6,7,3,0,0,207,203,164,39,103,146,113,37,172,100,72,111,62,424,189,235,70,52,208,94,"1600-035"
"1053",14,0,14,10,0,14,1,12,1,0,0,1,194,194,147,47,35,9,85,51,147,90,57,92,56,342,154,188,49,48,181,64,"1700-195"
"1054",45,44,0,45,39,6,0,45,0,0,0,8,45,44,36,8,11,33,31,3,36,19,17,30,16,110,51,59,15,23,39,33,"1700-194"
"1055",23,23,0,23,23,0,0,22,0,1,0,4,23,23,18,5,6,9,16,0,18,8,10,16,7,50,19,31,13,1,22,14,"1500-004"
"1056",8,0,8,6,0,8,0,0,8,0,0,0,151,151,109,42,61,87,78,13,109,71,38,67,33,249,112,137,34,25,117,73,"1700-180"
"1057",14,14,0,14,14,0,0,14,0,0,0,2,14,14,12,2,9,12,9,1,12,4,8,10,7,36,19,17,10,4,16,6,"1500-004"
"1058",42,27,15,41,34,8,1,30,7,4,0,21,235,235,191,44,98,109,110,52,191,130,61,106,63,435,219,216,79,29,270,57,"1900-458"
"1059",12,0,12,12,0,12,0,0,12,0,0,10,281,281,255,26,109,18,11,224,255,136,119,200,122,715,341,374,166,108,338,103,"1900-053"
"1060",40,40,0,40,40,0,0,40,0,0,0,40,40,40,39,1,0,2,2,37,39,25,14,28,11,98,47,51,7,13,45,33,"1500-462"
"1061",45,21,24,40,18,27,41,2,0,2,0,3,129,129,74,55,1,1,16,54,74,60,14,34,15,137,67,70,13,16,69,39,"1200-322"
"1062",9,0,9,9,0,9,0,7,0,2,0,0,174,174,144,30,88,132,110,22,144,91,53,91,48,345,166,179,56,43,143,103,"1400-081"
"1063",15,3,12,10,4,11,2,12,1,0,0,2,64,64,31,33,4,2,13,17,31,26,5,19,3,64,26,38,4,2,48,10,"1150-532"
"1064",19,0,19,19,0,19,0,19,0,0,0,0,173,173,146,26,7,0,11,130,147,92,55,103,47,362,159,203,65,33,172,92,"1300-070"
"1065",17,0,17,8,0,17,5,11,1,0,0,8,145,145,118,26,13,1,40,67,119,90,29,66,35,247,114,133,44,22,124,57,"1350-177"
"1066",1,0,1,0,0,1,1,0,0,0,0,1,3,3,3,0,0,0,0,2,3,2,1,2,1,7,3,4,2,0,4,1,"1200-093"
"1067",64,39,25,58,37,27,48,10,6,0,0,36,204,204,159,45,14,46,60,82,159,128,31,80,32,303,134,169,30,26,157,90,"1300-340"
"1068",5,4,0,5,1,4,1,4,0,0,0,0,5,4,4,0,2,4,4,0,4,1,3,4,1,21,11,10,2,6,10,3,"1400-239"
"1069",15,14,1,15,4,11,1,8,4,1,1,1,19,19,16,3,11,16,12,3,16,9,7,12,5,40,21,19,5,5,19,11,"1400-004"
"1070",15,15,0,15,13,2,0,15,0,0,0,8,15,15,15,0,1,10,13,1,15,4,11,14,8,49,24,25,11,5,23,10,"1400-099"
"1071",15,15,0,15,15,0,8,5,1,1,0,3,18,18,15,3,6,3,9,5,15,11,4,13,4,38,18,20,7,3,9,19,"1400-210"
"1072",22,18,4,21,18,4,4,15,1,0,2,12,60,60,44,16,24,21,17,23,44,35,9,21,11,83,35,48,20,2,49,12,"1349-019"
"1073",10,8,2,10,10,0,2,4,1,0,3,2,22,22,19,3,6,14,14,3,19,8,11,15,11,56,29,27,15,6,29,6,"1400-077"
"1074",39,27,12,36,26,13,17,17,4,1,0,4,109,109,81,28,12,21,44,33,81,62,19,42,19,162,69,93,22,12,80,48,"1300-402"
"1075",17,10,6,16,8,9,0,14,0,2,1,6,37,36,25,11,5,9,13,12,25,16,9,16,9,83,29,54,11,4,31,37,"1400-128"
"1076",8,8,0,8,8,0,0,8,0,0,0,1,8,8,5,3,2,4,5,0,5,2,3,4,3,20,9,11,6,3,8,3,"1400-140"
"1077",6,6,0,6,6,0,6,0,0,0,0,0,6,6,5,1,1,4,4,0,5,2,3,4,3,16,7,9,5,2,7,2,"1400-290"
"1078",47,12,35,42,11,36,16,8,4,15,4,2,314,314,253,61,165,176,162,78,253,160,93,159,87,597,280,317,111,57,324,105,"1400-035"
"1079",6,4,2,6,4,2,6,0,0,0,0,6,14,14,4,10,2,0,1,3,4,4,0,2,0,7,3,4,0,0,2,5,"1300-300"
"1080",28,15,13,22,17,11,28,0,0,0,0,18,63,63,38,25,3,1,6,30,38,25,13,20,7,79,29,50,5,6,46,22,"1300-315"
"1081",0,0,0,0,0,0,0,0,0,0,0,0,0,0,0,0,0,0,0,0,0,0,0,0,0,0,0,0,0,0,0,0,"1300-344"
"1082",3,0,3,1,0,3,3,0,0,0,0,0,73,73,48,25,3,9,11,35,48,42,6,15,3,77,28,49,3,1,50,23,"1500-500"
"1083",8,0,8,8,0,8,0,4,4,0,0,2,242,242,203,39,127,118,150,42,203,125,78,140,65,474,212,262,48,59,246,121,"1500-088"
"1084",7,7,0,7,7,0,0,7,0,0,0,0,7,7,5,2,1,3,5,0,5,3,2,3,2,11,3,8,1,3,5,2,"1349-016"
"1085",19,1,18,10,2,17,19,0,0,0,0,17,57,57,33,24,0,0,7,26,33,28,5,13,5,55,29,26,4,5,33,13,"1100-218"
"1086",2,1,1,2,0,2,2,0,0,0,0,1,8,8,5,3,0,0,0,5,5,2,3,0,0,15,12,3,0,2,13,0,"1100-054"
"1087",9,1,8,5,1,8,0,4,4,1,0,1,27,27,12,15,4,4,8,4,12,4,8,11,8,40,16,24,10,6,19,5,"1150-532"
"1088",6,6,0,6,3,3,0,6,0,0,0,0,8,8,7,1,2,4,6,1,7,3,4,5,3,21,10,11,3,5,10,3,"1349-016"
"1089",37,4,33,20,3,34,35,0,2,0,0,20,154,154,100,54,7,0,8,84,100,88,12,33,14,160,68,92,11,10,88,51,"1100-349"
"1090",13,1,12,6,2,11,12,1,0,0,0,1,60,60,46,14,2,6,10,31,46,38,8,24,12,87,44,43,11,8,48,20,"1200-012"
"1091",10,0,10,10,0,10,0,10,0,0,0,3,107,107,96,10,3,2,1,91,97,56,41,67,34,254,137,117,47,31,106,70,"1300-070"
"1092",16,2,14,13,5,11,9,6,0,1,0,11,96,96,66,30,5,7,38,21,66,47,19,32,14,134,61,73,16,10,82,26,"1300-095"
"1093",39,38,0,39,18,21,2,36,1,0,0,5,43,42,35,7,9,27,30,4,35,15,20,28,19,113,55,58,14,20,54,25,"1400-140"
"1094",0,0,0,0,0,0,0,0,0,0,0,0,0,0,0,0,0,0,0,0,0,0,0,0,0,0,0,0,0,0,0,0,"1300-477"
"1095",31,15,16,28,14,17,30,1,0,0,0,5,101,101,65,36,3,10,24,32,65,41,24,43,19,153,76,77,16,16,94,27,"1150-237"
"1096",6,2,4,6,1,5,6,0,0,0,0,1,27,27,3,24,0,0,0,2,3,2,1,1,1,8,3,5,3,2,3,0,"1250-148"
"1097",33,8,22,25,1,32,19,11,1,1,1,15,197,194,141,53,19,12,68,57,141,86,55,97,52,448,181,267,69,27,191,161,"1250-190"
"1098",21,0,21,13,0,21,19,1,0,0,1,17,151,151,101,50,7,4,30,57,101,80,21,52,25,192,91,101,27,11,106,48,"1250-136"
"1099",6,0,4,4,0,6,3,2,0,0,1,0,51,50,40,10,8,0,11,24,40,32,8,16,6,88,34,54,5,6,33,44,"1170-217"
"1100",26,3,23,24,7,19,21,4,0,1,0,12,225,225,162,63,13,6,40,105,162,126,36,70,29,306,150,156,30,23,191,62,"1150-314"
"1101",17,0,15,11,0,17,7,8,0,1,1,15,132,130,101,29,8,1,40,55,101,73,28,53,25,242,113,129,27,15,148,52,"1170-212"
"1102",4,4,0,4,4,0,4,0,0,0,0,0,5,5,4,1,1,3,3,0,4,2,2,2,2,11,4,7,4,1,5,1,"1400-290"
"1103",0,0,0,0,0,0,0,0,0,0,0,0,0,0,0,0,0,0,0,0,0,0,0,0,0,0,0,0,0,0,0,0,"1400-209"
"1104",8,8,0,8,8,0,0,8,0,0,0,0,8,8,7,1,1,3,7,0,7,1,6,7,5,25,12,13,9,1,10,5,"1400-085"
"1105",5,0,5,5,0,5,0,0,3,2,0,0,136,136,96,40,88,93,71,17,96,61,35,59,36,210,108,102,25,25,130,30,"1800-142"
"1106",12,7,5,11,7,5,7,0,5,0,0,9,154,154,129,25,96,122,105,16,129,70,59,92,49,321,148,173,41,40,185,55,"1800-048"
"1107",17,0,17,17,0,17,0,1,16,0,0,0,200,200,177,23,144,167,152,14,177,111,66,125,57,416,199,217,47,48,218,103,"1600-776"
"1108",22,15,7,21,22,0,0,22,0,0,0,11,39,39,27,12,5,11,24,2,27,20,7,20,6,58,28,30,3,8,22,25,"1800-142"
"1109",17,10,7,16,10,7,0,11,6,0,0,17,94,94,84,10,64,73,68,9,84,58,26,57,21,183,81,102,14,20,104,45,"1600-546"
"1110",15,0,15,11,0,15,0,13,2,0,0,5,190,190,153,37,55,70,90,50,153,120,33,76,30,287,130,157,26,18,145,98,"1750-143"
"1111",50,50,0,50,29,21,0,44,1,2,3,26,52,52,38,14,2,37,36,2,38,21,17,34,14,103,37,66,12,13,46,32,"1800-364"
"1112",16,12,4,16,16,0,0,15,0,1,0,8,32,32,29,3,6,14,16,8,29,22,7,13,5,56,25,31,3,5,28,20,"1800-142"
"1113",30,29,0,30,30,0,1,27,1,0,1,26,30,29,23,6,10,0,0,23,23,14,9,18,10,61,24,37,11,5,27,18,"1600-647"
"1114",0,0,0,0,0,0,0,0,0,0,0,0,0,0,0,0,0,0,0,0,0,0,0,0,0,0,0,0,0,0,0,0,"1800-111"
"1115",17,5,12,14,3,14,4,13,0,0,0,4,61,61,30,31,5,6,10,19,30,24,6,11,5,54,27,27,6,6,35,7,"1200-786"
"1116",23,14,9,23,11,12,12,4,5,0,2,0,125,125,95,30,26,65,48,36,95,62,33,56,33,221,115,106,45,30,112,34,"1350-070"
"1117",13,3,10,13,5,8,12,0,0,0,1,13,42,42,29,12,0,0,2,25,30,24,6,16,5,60,26,34,3,8,44,5,"1300-611"
"1118",13,13,0,13,2,11,0,9,0,4,0,2,14,14,12,2,3,10,8,4,12,5,7,11,7,44,19,25,15,6,16,7,"1400-188"
"1119",16,0,16,13,0,16,0,16,0,0,0,6,192,192,140,52,16,1,57,76,140,102,38,92,36,304,120,184,47,21,127,109,"1349-016"
"1120",25,14,11,24,17,8,20,0,0,0,5,23,70,70,37,33,0,0,12,22,37,29,8,21,8,74,32,42,4,6,43,21,"1300-611"
"1121",21,15,6,19,14,7,11,10,0,0,0,21,37,37,19,18,1,0,8,11,19,16,3,7,3,32,13,19,1,6,18,7,"1350-259"
"1122",3,1,2,3,0,3,3,0,0,0,0,1,25,25,6,19,1,0,3,2,6,5,1,2,1,10,7,3,2,0,7,1,"1249-002"
"1123",9,6,3,8,5,4,0,2,5,0,2,2,31,31,26,5,12,26,24,1,26,20,6,16,6,52,24,28,7,3,21,21,"1400-905"
"1124",19,19,0,19,1,18,0,0,19,0,0,8,27,27,25,2,1,13,21,3,25,16,9,18,9,63,32,31,12,8,26,17,"1400-185"
"1125",2,0,2,1,0,2,1,1,0,0,0,1,11,11,8,3,0,0,2,6,8,7,1,5,1,15,6,9,2,0,9,4,"1200-478"
"1126",13,0,13,7,0,13,0,13,0,0,0,5,229,229,180,49,27,2,68,96,180,143,37,91,41,349,148,201,41,30,156,122,"1400-191"
"1127",0,0,0,0,0,0,0,0,0,0,0,0,0,0,0,0,0,0,0,0,0,0,0,0,0,0,0,0,0,0,0,0,"1200-479"
"1128",6,1,4,6,2,4,5,1,0,0,0,2,21,20,17,3,1,0,4,12,17,10,7,12,8,45,21,24,11,3,24,7,"1300-371"
"1129",15,15,0,15,5,10,0,12,2,0,1,5,15,15,10,5,2,9,10,0,10,4,6,10,7,32,18,14,3,9,17,3,"1400-318"
"1130",10,5,5,10,4,6,6,1,0,3,0,3,39,39,28,11,15,16,20,6,28,16,12,21,11,71,30,41,10,11,32,18,"1200-756"
"1131",3,0,3,3,0,3,0,3,0,0,0,0,24,24,15,9,10,2,11,3,15,10,5,10,4,37,20,17,2,8,19,8,"1400-350"
"1132",30,7,23,29,4,26,5,16,4,4,1,5,312,312,236,76,17,12,150,62,236,181,55,142,48,466,211,255,43,30,247,146,"1300-166"
"1133",8,1,7,4,0,8,0,7,1,0,0,4,30,30,11,19,0,0,6,5,11,9,2,2,1,18,9,9,0,5,12,1,"1200-129"
"1134",3,0,3,1,0,3,0,3,0,0,0,2,19,19,15,4,1,0,3,9,15,12,3,7,2,30,13,17,2,5,16,7,"1200-292"
"1135",28,24,4,28,26,2,25,2,0,1,0,10,50,50,31,10,8,3,4,25,40,30,10,21,9,78,39,39,11,3,39,25,"1349-021"
"1136",5,0,5,3,0,5,0,0,0,5,0,0,226,226,194,32,190,193,156,23,194,116,78,132,59,453,223,230,60,51,226,116,"1990-078"
"1137",10,0,10,8,0,10,0,10,0,0,0,1,131,131,107,24,13,0,80,14,107,72,35,60,26,227,101,126,25,26,95,81,"1800-105"
"1138",6,3,2,6,3,3,1,0,2,2,1,1,25,24,22,2,18,22,17,2,22,11,11,18,7,71,38,33,6,6,46,13,"1750-147"
"1139",13,0,13,13,0,13,0,13,0,0,0,0,178,178,154,24,50,2,93,54,154,90,64,104,55,376,180,196,62,37,190,87,"1800-087"
"1140",6,0,6,6,0,6,0,6,0,0,0,4,76,76,61,15,6,1,47,7,61,37,24,38,23,143,70,73,17,23,68,35,"1800"
"1141",5,0,5,5,0,5,0,0,5,0,0,0,72,72,55,17,40,52,46,6,55,38,17,42,16,126,55,71,8,17,60,41,"1750-147"
"1142",14,14,0,14,14,0,0,14,0,0,0,1,14,14,10,4,4,9,10,0,10,3,7,10,6,31,15,16,4,3,19,5,"1800-129"
"1143",10,0,10,9,0,10,0,0,8,2,0,2,188,188,148,40,120,143,131,10,148,80,68,113,59,389,189,200,64,47,210,68,"1750-126"
"1144",11,0,11,11,0,11,0,11,0,0,0,10,88,88,63,25,2,2,47,13,63,40,23,43,18,145,70,75,16,12,86,31,"1800-100"
"1145",6,0,6,6,0,6,0,0,6,0,0,3,134,134,122,12,85,2,3,117,122,87,35,74,26,252,115,137,19,22,137,74,"1600-248"
"1146",11,0,11,9,0,11,0,0,8,2,1,0,163,163,141,22,119,136,117,15,141,77,64,107,53,359,181,178,43,48,177,91,"1750-170"
"1147",113,113,0,113,85,28,0,83,30,0,0,2,113,113,100,13,9,25,79,17,100,67,33,68,24,230,105,125,40,10,92,88,"1600-645"
"1148",6,0,6,4,0,6,0,6,0,0,0,0,122,122,97,25,60,0,76,13,97,57,40,67,38,231,110,121,35,32,117,47,"1800"
"1149",16,0,16,16,0,16,0,7,9,0,0,3,231,231,196,35,152,186,152,33,196,127,69,140,54,444,215,229,46,41,247,110,"1750-170"
"1150",9,0,9,9,0,9,0,9,0,0,0,0,62,62,55,7,6,0,41,8,55,41,14,27,9,111,52,59,11,7,65,28,"1800"
"1151",8,0,8,5,0,8,8,0,0,0,0,7,37,37,25,12,2,0,19,3,25,14,11,19,10,66,38,28,6,12,32,16,"1250-238"
"1152",12,6,5,9,7,5,9,2,1,0,0,7,22,21,16,5,3,1,9,3,16,10,6,14,6,58,31,27,21,6,19,12,"1200-192"
"1153",20,1,19,18,4,16,3,11,4,2,0,19,279,279,226,53,81,141,154,48,226,172,54,144,49,451,188,263,43,36,214,158,"1350-039"
"1154",53,27,26,42,33,20,36,13,1,3,0,29,167,167,128,39,16,9,17,102,128,86,42,69,33,306,171,135,50,24,168,64,"1100-178"
"1155",11,1,10,7,0,11,4,5,2,0,0,8,39,39,17,22,1,0,3,11,17,9,8,10,6,40,19,21,7,5,21,7,"1200-147"
"1156",5,0,5,5,0,5,0,0,5,0,0,4,37,37,34,3,16,1,23,7,34,20,14,20,11,72,37,35,7,6,48,11,"1400-392"
"1157",32,31,0,32,29,3,0,25,7,0,0,6,32,31,23,8,8,14,21,1,23,15,8,18,5,69,26,43,5,3,30,31,"1500-618"
"1158",35,17,18,33,20,15,16,13,5,0,1,20,154,154,74,80,18,7,36,33,74,61,13,30,7,129,53,76,5,9,74,41,"1600-140"
"1159",12,0,12,10,1,11,3,5,0,4,0,0,125,125,100,25,55,51,58,38,100,77,23,60,22,197,91,106,17,18,94,68,NA
"1160",34,34,0,34,32,2,0,33,0,1,0,3,34,34,33,1,9,21,31,0,33,16,17,27,13,89,42,47,14,7,48,20,"1500-481"
"1161",0,0,0,0,0,0,0,0,0,0,0,0,0,0,0,0,0,0,0,0,0,0,0,0,0,0,0,0,0,0,0,0,"1500-376"
"1162",23,23,0,23,22,1,0,18,2,3,0,2,23,23,20,3,6,15,20,0,20,6,14,18,13,66,28,38,18,8,34,6,"1500-481"
"1163",36,6,30,32,6,30,9,26,0,1,0,6,224,224,177,47,23,29,45,113,177,130,47,82,39,352,157,195,46,32,173,101,"1700-145"
"1164",4,0,4,4,0,4,0,4,0,0,0,0,37,37,30,7,4,5,19,8,30,23,7,12,4,56,28,28,2,5,27,22,"1700-364"
"1165",29,29,0,29,25,4,0,25,2,2,0,6,29,29,22,7,6,13,19,1,22,15,7,15,4,50,28,22,5,3,25,17,"1500-481"
"1166",4,0,4,3,0,4,0,4,0,0,0,0,79,79,66,13,1,3,43,18,66,39,27,42,27,153,74,79,25,18,75,35,"1950-230"
"1167",6,0,6,5,0,6,0,6,0,0,0,1,282,282,252,30,197,1,82,156,252,153,99,190,73,633,295,338,73,74,296,190,"1950-157"
"1168",5,0,3,4,0,5,0,0,5,0,0,0,194,192,125,67,118,125,102,13,129,83,46,87,41,296,145,151,32,33,155,76,"1600-028"
"1169",2,0,2,0,0,2,2,0,0,0,0,1,3,3,3,0,0,0,0,2,3,2,1,1,1,7,5,2,2,1,4,0,"1100-053"
"1170",9,2,7,8,2,7,8,0,1,0,0,3,40,40,28,12,4,4,9,13,28,18,10,18,10,66,28,38,13,6,29,18,"1200"
"1171",12,2,10,8,0,12,11,0,0,1,0,1,93,93,47,46,17,25,22,19,47,45,2,15,4,66,37,29,6,0,49,11,"1200-336"
"1172",10,0,9,6,0,10,8,2,0,0,0,1,57,57,32,25,3,2,19,8,32,17,15,20,14,82,49,33,11,17,44,10,"1200-994"
"1173",11,1,10,7,2,9,9,1,1,0,0,4,45,45,21,24,2,0,8,13,21,13,8,11,5,51,28,23,2,8,27,14,"1200-056"
"1174",12,2,10,5,2,10,12,0,0,0,0,12,48,48,19,29,2,0,1,17,19,16,3,7,0,36,21,15,0,0,28,8,"1100-542"
"1175",5,0,5,1,0,5,5,0,0,0,0,4,25,25,11,14,1,0,1,10,11,6,5,2,2,28,23,5,3,2,21,2,"1100-166"
"1176",3,0,2,2,0,3,3,0,0,0,0,1,15,14,6,8,0,1,4,2,6,5,1,3,1,14,8,6,1,0,8,5,NA
"1177",9,0,9,9,0,9,1,8,0,0,0,6,73,73,56,17,17,13,39,13,56,29,27,39,27,156,74,82,36,26,68,26,"1350-179"
"1178",32,31,1,32,32,0,32,0,0,0,0,27,36,36,16,20,6,0,0,12,16,8,8,11,5,39,21,18,4,4,20,11,"1349-016"
"1179",0,0,0,0,0,0,0,0,0,0,0,0,0,0,0,0,0,0,0,0,0,0,0,0,0,0,0,0,0,0,0,0,"1200-243"
"1180",10,4,6,5,2,8,6,1,3,0,0,0,33,33,16,17,7,7,5,11,16,13,3,8,4,29,17,12,4,4,14,7,"1200-128"
"1181",6,0,6,4,0,6,5,0,0,1,0,0,55,55,28,27,18,20,18,9,28,24,4,13,5,50,27,23,5,4,26,15,"1200-623"
"1182",4,0,4,1,0,4,4,0,0,0,0,3,15,15,5,10,0,0,3,2,5,5,0,2,0,8,3,5,0,0,4,4,"1100-203"
"1183",20,4,16,19,1,19,16,2,0,0,2,5,76,76,48,28,7,9,21,24,48,32,16,26,11,103,48,55,17,3,48,35,"1200-857"
"1184",31,4,26,18,2,29,31,0,0,0,0,9,115,114,51,63,4,3,23,26,51,39,12,25,10,128,57,71,4,18,60,46,"1200-096"
"1185",13,1,12,11,2,11,4,7,1,1,0,6,52,52,32,20,4,4,14,17,32,27,5,14,5,54,24,30,6,0,33,15,"1200-624"
"1186",11,0,11,8,0,11,0,11,0,0,0,1,150,150,133,17,20,7,45,82,133,86,47,71,41,297,128,169,51,27,135,84,"1400-325"
"1187",25,4,21,20,1,24,14,1,0,5,5,4,143,143,47,96,12,26,26,18,47,40,7,28,9,87,44,43,8,10,42,27,"1200-014"
"1188",11,1,10,5,2,9,11,0,0,0,0,4,39,39,21,18,4,0,4,17,21,18,3,6,1,31,11,20,1,1,20,9,"1200-341"
"1189",17,0,17,8,0,17,15,1,0,1,0,1,100,100,67,33,4,2,31,34,67,55,12,29,11,123,58,65,7,13,71,32,"1200-085"
"1190",58,30,27,57,39,19,19,22,6,1,10,15,181,180,132,48,38,67,60,65,132,73,59,96,59,361,163,198,61,31,185,84,"1300-134"
"1191",7,1,5,2,0,7,7,0,0,0,0,5,38,37,21,16,1,0,0,20,22,19,3,9,1,39,24,15,0,2,34,3,"1100-203"
"1192",9,9,0,9,6,3,6,2,1,0,0,4,11,11,8,3,2,6,7,0,8,5,3,8,3,23,11,12,3,3,13,4,"1349-016"
"1193",1,1,0,1,1,0,0,1,0,0,0,1,1,1,1,0,0,0,0,1,1,0,1,1,0,3,1,2,0,0,1,2,"1400-081"
"1194",16,6,10,15,7,9,14,0,1,1,0,9,53,53,43,10,5,0,4,36,43,37,6,12,5,70,44,26,6,5,53,6,"1100-474"
"1195",16,2,14,15,4,12,16,0,0,0,0,4,77,77,33,44,3,0,7,23,33,21,12,22,6,77,35,42,6,5,44,22,"1100-335"
"1196",17,2,14,14,0,17,10,2,0,5,0,8,67,66,51,15,1,0,8,40,51,38,13,24,13,109,52,57,11,11,67,20,"1150-303"
"1197",27,27,0,27,9,18,0,18,4,5,0,3,27,27,20,7,2,10,18,1,20,11,9,15,10,52,26,26,8,8,30,6,"1400-406"
"1198",28,28,0,28,9,19,1,19,8,0,0,3,28,28,24,4,7,16,20,2,24,14,10,17,10,57,26,31,6,10,31,10,"1400-406"
"1199",24,24,0,24,6,18,0,19,3,2,0,3,24,24,17,7,1,7,15,0,17,7,10,14,9,52,23,29,13,6,27,6,"1400-406"
"1200",15,3,12,11,3,12,6,3,0,0,6,4,162,162,67,95,40,47,33,28,67,52,15,24,9,125,68,57,9,8,93,15,"1100-390"
"1201",0,0,0,0,0,0,0,0,0,0,0,0,0,0,0,0,0,0,0,0,0,0,0,0,0,0,0,0,0,0,0,0,"1100-621"
"1202",0,0,0,0,0,0,0,0,0,0,0,0,0,0,0,0,0,0,0,0,0,0,0,0,0,0,0,0,0,0,0,0,"1750-478"
"1203",16,5,11,15,4,12,0,11,5,0,0,1,82,82,73,9,4,6,19,51,73,37,36,63,36,198,94,104,32,29,105,32,"2680"
"1204",0,0,0,0,0,0,0,0,0,0,0,0,0,0,0,0,0,0,0,0,0,0,0,0,0,0,0,0,0,0,0,0,"1990-514"
"1205",21,6,15,21,5,16,0,9,12,0,0,2,98,98,85,13,3,20,18,61,85,41,44,69,43,243,114,129,51,41,122,29,"2680"
"1206",22,1,21,17,1,21,9,12,0,0,1,0,210,210,176,34,41,15,44,116,176,136,40,85,36,344,147,197,41,26,195,82,"1000-105"
"1207",33,10,23,33,10,23,9,21,2,1,0,12,194,194,124,70,5,3,66,39,124,103,21,55,17,221,91,130,10,23,122,66,"1600-093"
"1208",14,3,11,11,3,11,0,13,0,1,0,2,133,133,105,28,17,17,30,68,105,73,32,57,30,216,97,119,38,15,108,55,"1000-016"
"1209",29,23,6,24,18,11,0,3,26,0,0,3,169,169,144,25,84,9,128,8,144,93,51,102,37,337,164,173,28,40,183,86,"1500-618"
"1210",60,33,26,55,41,19,0,24,18,18,0,18,204,203,156,46,46,47,59,88,157,92,65,109,71,406,185,221,79,49,205,73,"1500-678"
"1211",10,8,2,10,8,2,6,0,0,1,3,4,23,23,14,9,0,0,6,8,14,14,0,5,0,20,7,13,0,0,16,4,"1950-277"
"1212",21,0,21,20,0,21,3,17,1,0,0,0,190,190,148,42,22,3,45,93,148,112,36,73,36,274,117,157,36,22,143,73,"1000-182"
"1213",52,0,51,40,0,52,2,49,1,0,0,6,600,599,474,125,37,8,189,253,474,377,97,229,94,893,398,495,86,70,489,248,"1500-154"
"1214",9,0,9,8,0,9,0,2,3,4,0,0,226,226,179,47,132,165,152,13,179,110,69,114,61,402,178,224,38,61,208,95,"1500-110"
"1215",13,0,13,10,0,13,0,5,8,0,0,5,189,189,153,36,30,1,116,26,153,125,28,81,25,279,122,157,17,25,119,118,"1500-613"
"1216",15,0,15,13,0,15,0,15,0,0,0,3,91,91,76,15,8,10,34,34,76,49,27,49,31,184,81,103,43,20,81,40,"1700-237"
"1217",7,0,7,7,0,7,0,7,0,0,0,7,146,146,134,12,99,0,87,38,134,89,45,103,32,316,159,157,30,30,138,118,"1950-244"
"1218",11,0,11,9,0,11,0,0,10,1,0,11,190,190,160,30,44,122,120,31,160,105,55,104,41,352,165,187,36,35,176,105,"1500-998"
"1219",1,0,0,1,0,1,0,0,0,1,0,0,1,0,0,0,0,0,0,0,0,0,0,0,0,79,24,55,0,0,2,77,"1500-676"
"1220",8,1,7,7,1,7,0,8,0,0,0,2,72,72,59,13,18,1,36,19,59,38,21,34,17,129,53,76,9,20,69,31,"1700-111"
"1221",9,0,9,8,0,9,0,0,0,9,0,0,99,99,88,11,83,88,69,14,88,37,51,69,53,243,126,117,52,42,121,28,"1990-024"
"1222",17,0,17,17,0,17,0,17,0,0,0,0,155,155,118,36,8,0,58,50,119,92,27,60,26,228,87,141,26,21,101,80,"1749-063"
"1223",66,51,15,63,61,5,52,11,1,2,0,58,123,123,98,25,5,5,9,87,98,75,23,47,25,189,85,104,24,17,111,37,"1070-181"
"1224",34,14,20,29,15,19,32,1,0,0,1,5,132,132,87,45,8,13,19,59,87,60,27,40,19,195,92,103,33,15,124,23,"1050-018"
"1225",0,0,0,0,0,0,0,0,0,0,0,0,0,0,0,0,0,0,0,0,0,0,0,0,0,0,0,0,0,0,0,0,"1990-514"
"1226",18,0,18,17,0,18,1,17,0,0,0,5,432,432,383,49,207,4,207,160,383,250,133,276,99,888,398,490,97,69,368,354,"1950-004"
"1227",57,46,11,56,25,32,0,57,0,0,0,1,135,135,111,24,15,34,64,37,111,63,48,82,51,272,135,137,50,33,138,51,"1700-108"
"1228",3,0,3,1,0,3,0,3,0,0,0,0,111,111,76,35,55,1,40,26,76,59,17,36,8,148,66,82,14,7,61,66,"1500-235"
"1229",12,0,12,12,0,12,0,0,12,0,0,1,192,192,157,35,52,1,55,98,157,79,78,143,73,438,215,223,63,58,235,82,"1950-150"
"1230",10,0,10,7,0,10,0,10,0,0,0,6,60,60,50,10,1,0,39,8,50,37,13,27,10,105,50,55,16,6,63,20,"1700"
"1231",17,0,17,11,1,16,0,17,0,0,0,17,102,102,85,17,3,6,40,42,85,64,21,48,27,175,69,106,21,18,101,35,"1700-237"
"1232",19,0,19,15,0,19,0,19,0,0,0,8,285,285,236,49,47,2,102,116,236,188,48,133,43,453,198,255,33,31,201,188,"1500-250"
"1233",22,5,17,12,7,15,21,0,0,1,0,9,88,88,53,35,6,0,15,36,53,41,12,26,5,97,44,53,7,2,60,28,"1100-616"
"1234",19,0,19,18,0,19,0,0,16,3,0,2,341,341,288,53,189,281,231,38,288,194,94,209,90,658,316,342,65,88,318,187,"1600-219"
"1235",21,5,16,21,5,16,8,12,0,0,1,9,75,75,39,36,1,3,14,22,39,29,10,21,11,78,35,43,14,5,41,18,"1200-747"
"1236",13,0,13,11,2,11,1,12,0,0,0,13,65,65,38,27,2,1,20,16,38,26,12,23,8,88,42,46,11,5,47,25,"1350-188"
"1237",8,1,7,6,1,7,6,2,0,0,0,6,37,37,19,18,0,0,2,17,19,14,5,8,4,37,20,17,4,4,23,6,"1100-464"
"1238",5,0,5,4,0,5,5,0,0,0,0,3,26,26,9,17,0,0,5,4,9,8,1,2,1,13,5,8,1,1,7,4,"1200-010"
"1239",5,1,2,5,0,5,2,0,1,2,0,1,16,14,11,3,2,0,1,9,13,11,2,5,0,32,15,17,5,6,14,7,"1100-177"
"1240",5,1,4,2,0,5,4,0,0,1,0,0,45,45,28,17,9,12,11,15,28,20,8,12,10,53,23,30,8,4,31,10,"1200-249"
"1241",1,0,1,1,0,1,1,0,0,0,0,0,6,6,5,1,0,0,0,5,5,5,0,3,0,8,4,4,0,0,5,3,"1200-249"
"1242",9,2,7,2,1,8,9,0,0,0,0,6,27,27,13,14,0,0,6,7,13,12,1,7,3,23,13,10,3,0,9,11,"1200-211"
"1243",22,20,1,22,21,1,5,16,0,1,0,15,27,26,22,4,6,9,5,16,22,13,9,13,8,77,43,34,8,5,54,10,"1349-016"
"1244",8,6,2,5,0,8,8,0,0,0,0,4,14,14,12,2,2,6,8,2,12,5,7,10,6,35,17,18,1,12,16,6,"1249-122"
"1245",59,45,14,52,44,15,34,19,0,5,1,28,143,143,90,53,11,6,16,68,90,67,23,39,21,177,87,90,29,12,96,40,"1100-274"
"1246",31,10,20,20,11,20,19,6,1,4,1,13,127,126,60,66,2,2,12,40,60,42,18,36,7,144,74,70,7,9,77,51,"1100-624"
"1247",22,3,18,17,5,17,7,15,0,0,0,14,178,177,147,30,32,47,83,53,147,98,49,81,45,383,139,244,44,53,155,131,"1350-290"
"1248",12,1,11,10,4,8,12,0,0,0,0,4,46,46,33,13,5,1,4,26,33,26,7,14,7,57,24,33,4,6,31,16,"1100-616"
"1249",24,24,0,24,23,1,1,22,1,0,0,1,24,24,21,3,2,3,19,2,21,11,10,18,7,53,29,24,8,2,29,14,"1400-081"
"1250",11,7,4,7,3,8,5,6,0,0,0,7,19,19,15,4,0,0,3,8,15,13,2,8,4,27,13,14,2,6,14,5,"1100-466"
"1251",14,3,10,10,0,14,14,0,0,0,0,9,49,48,24,24,0,0,6,17,25,18,7,11,5,50,29,21,4,3,27,16,"1200-146"
"1252",18,0,18,12,1,17,18,0,0,0,0,9,96,96,57,39,2,2,11,44,57,47,10,22,7,99,48,51,8,4,55,32,"1100-177"
"1253",8,0,8,3,1,7,8,0,0,0,0,1,44,44,34,10,1,0,12,20,34,29,5,14,5,56,28,28,6,4,30,16,"1100-234"
"1254",7,1,6,5,2,5,5,1,0,0,1,1,35,35,21,14,2,1,2,18,21,19,2,9,1,34,19,15,1,2,19,12,"1100-466"
"1255",0,0,0,0,0,0,0,0,0,0,0,0,0,0,0,0,0,0,0,0,0,0,0,0,0,0,0,0,0,0,0,0,NA
"1256",45,7,38,42,9,36,14,31,0,0,0,26,316,316,243,73,28,24,86,140,243,174,69,145,68,527,250,277,60,58,276,133,"1200-601"
"1257",30,8,22,26,4,26,26,2,1,1,0,11,113,113,67,46,3,10,29,34,67,48,19,34,17,141,60,81,22,15,65,39,"1200-366"
"1258",19,19,0,19,19,0,0,19,0,0,0,5,19,19,15,4,4,4,14,0,15,8,7,10,3,37,15,22,4,1,22,10,"1400-081"
"1259",7,1,5,4,4,3,7,0,0,0,0,5,23,23,13,10,0,0,3,10,13,9,4,5,2,24,10,14,0,2,10,12,"1100-591"
"1260",1,0,0,0,0,1,0,0,0,0,1,0,1,1,1,0,1,1,1,0,1,1,0,0,0,1,1,0,0,0,1,0,"1200-146"
"1261",11,0,11,3,0,11,9,1,1,0,0,5,48,48,28,20,0,0,10,18,28,25,3,11,4,43,17,26,1,5,28,9,"1100-116"
"1262",11,3,8,5,2,9,11,0,0,0,0,10,28,28,13,15,1,1,3,9,13,8,5,7,4,31,16,15,4,5,20,2,"1200-459"
"1263",14,1,13,7,1,13,12,2,0,0,0,4,96,96,67,29,3,2,14,51,67,50,17,35,12,132,67,65,17,6,71,38,"1200-236"
"1264",22,22,0,22,22,0,0,22,0,0,0,2,22,22,19,3,4,5,16,2,19,11,8,15,6,52,27,25,5,4,26,17,"1400-081"
"1265",34,3,31,23,1,33,26,4,3,1,0,17,233,233,150,83,28,41,77,65,150,105,45,79,32,315,155,160,37,22,194,62,"1169-024"
"1266",0,0,0,0,0,0,0,0,0,0,0,0,0,0,0,0,0,0,0,0,0,0,0,0,0,0,0,0,0,0,0,0,"1200-459"
"1267",13,1,12,8,1,12,13,0,0,0,0,3,56,56,39,17,4,2,3,35,39,23,16,12,6,99,72,27,6,10,77,6,"1150-169"
"1268",20,5,15,13,5,15,18,2,0,0,0,1,94,94,65,29,2,5,23,40,65,54,11,33,10,120,50,70,11,7,61,41,"1200-296"
"1269",4,1,3,4,1,3,0,4,0,0,0,2,15,15,12,3,1,3,1,10,12,7,5,9,7,28,14,14,8,1,15,4,"1200-666"
"1270",41,0,41,33,0,41,0,41,0,0,0,17,499,499,369,130,16,8,107,229,369,258,111,218,105,798,362,436,109,82,440,167,"1000-009"
"1271",10,4,6,5,7,3,10,0,0,0,0,6,25,25,18,7,0,0,7,9,18,14,4,10,3,39,16,23,4,4,20,11,"1269-127"
"1272",43,0,43,39,0,43,0,42,1,0,0,14,376,376,316,60,11,7,110,180,316,243,73,169,81,598,269,329,60,58,305,175,"1500-345"
"1273",38,10,28,34,9,29,1,36,0,1,0,0,288,288,216,72,12,18,91,104,216,166,50,103,43,407,174,233,44,22,214,127,"1500-334"
"1274",19,0,19,17,0,19,0,17,2,0,0,4,308,308,218,90,38,15,130,66,218,177,41,95,32,403,179,224,35,27,215,126,"1500-540"
"1275",0,0,0,0,0,0,0,0,0,0,0,0,0,0,0,0,0,0,0,0,0,0,0,0,0,0,0,0,0,0,0,0,"1700-421"
"1276",0,0,0,0,0,0,0,0,0,0,0,0,0,0,0,0,0,0,0,0,0,0,0,0,0,0,0,0,0,0,0,0,NA
"1277",14,1,13,7,1,13,14,0,0,0,0,8,58,58,44,14,4,0,8,33,44,35,9,15,5,78,42,36,7,3,54,14,"1200-656"
"1278",20,9,11,16,3,17,16,1,3,0,0,8,60,60,36,24,6,6,11,23,36,28,8,18,7,73,34,39,10,7,39,17,"1200"
"1279",39,19,20,37,19,20,12,19,7,1,0,26,285,285,246,39,73,64,108,126,246,173,73,149,67,526,231,295,62,44,266,154,"1300-021"
"1280",2,0,2,1,0,2,0,2,0,0,0,0,7,7,1,6,0,0,1,0,1,0,1,1,1,4,3,1,2,0,2,0,"1200-719"
"1281",14,10,4,14,0,14,0,0,14,0,0,7,61,61,47,14,10,18,35,5,47,24,23,33,24,123,56,67,23,25,56,19,"1400-188"
"1282",3,0,3,2,0,3,0,0,1,2,0,0,50,50,41,9,19,39,30,8,41,23,18,26,16,100,40,60,15,13,52,20,"1400-041"
"1283",16,2,14,16,1,15,8,7,0,0,1,4,91,91,70,21,15,13,22,42,70,44,26,46,22,181,80,101,27,29,88,37,"1200-758"
"1284",0,0,0,0,0,0,0,0,0,0,0,0,0,0,0,0,0,0,0,0,0,0,0,0,0,0,0,0,0,0,0,0,NA
"1285",21,16,5,19,4,17,17,4,0,0,0,16,40,40,32,8,5,14,19,10,32,21,11,19,8,73,38,35,12,7,34,20,"1249-021"
"1286",0,0,0,0,0,0,0,0,0,0,0,0,0,0,0,0,0,0,0,0,0,0,0,0,0,0,0,0,0,0,0,0,"1100-063"
"1287",11,3,7,11,1,10,7,2,0,1,1,3,46,45,31,14,9,11,13,13,32,18,14,20,10,79,41,38,14,5,45,15,"1200-840"
"1288",15,2,13,10,3,12,2,10,0,0,3,1,130,130,55,75,10,10,14,38,55,44,11,23,10,105,62,43,9,9,77,10,"1200-649"
"1289",15,2,13,12,2,13,15,0,0,0,0,12,69,69,37,32,1,0,4,31,37,31,6,16,5,64,31,33,4,6,35,19,"1200"
"1290",4,1,3,3,1,3,0,3,0,0,1,2,9,9,1,8,0,0,0,1,1,0,1,1,1,3,1,2,0,1,1,1,"1200-070"
"1291",28,3,25,16,2,26,26,0,0,0,2,15,115,115,67,48,3,9,32,31,67,38,29,46,30,166,71,95,22,29,97,18,"1200-718"
"1292",26,1,25,10,0,26,15,11,0,0,0,4,137,137,86,51,8,1,31,47,86,50,36,50,25,227,129,98,37,24,136,30,"1200-429"
"1293",19,3,16,16,1,18,19,0,0,0,0,12,76,76,38,38,2,0,8,26,38,28,10,21,7,79,38,41,7,1,51,20,"1200"
"1294",36,1,35,30,1,35,33,2,0,0,1,24,142,142,85,57,4,1,26,53,85,68,17,40,16,164,71,93,19,13,89,43,"1200-660"
"1295",0,0,0,0,0,0,0,0,0,0,0,0,0,0,0,0,0,0,0,0,0,0,0,0,0,0,0,0,0,0,0,0,NA
"1296",10,4,6,8,1,9,7,0,3,0,0,2,32,32,19,13,1,4,7,10,19,14,5,11,6,43,26,17,4,5,28,6,"1200-005"
"1297",0,0,0,0,0,0,0,0,0,0,0,0,0,0,0,0,0,0,0,0,0,0,0,0,0,0,0,0,0,0,0,0,"1149-027"
"1298",11,0,11,9,0,11,0,0,11,0,0,0,82,82,71,11,23,70,55,11,71,47,24,48,26,160,81,79,19,22,78,41,"1400-188"
"1299",11,0,11,9,0,11,0,10,1,0,0,0,160,160,129,31,55,1,73,44,129,87,42,77,36,291,147,144,40,28,135,88,"1400-203"
"1300",12,0,12,9,0,12,0,0,2,10,0,4,122,122,104,18,48,100,76,21,104,56,48,71,47,262,112,150,58,31,135,38,"1400-185"
"1301",0,0,0,0,0,0,0,0,0,0,0,0,0,0,0,0,0,0,0,0,0,0,0,0,0,0,0,0,0,0,0,0,NA
"1302",15,3,12,13,1,14,0,15,0,0,0,7,94,94,69,25,11,15,32,33,69,50,19,35,14,139,63,76,17,9,77,36,"1200-758"
"1303",9,0,9,7,0,9,0,9,0,0,0,7,121,121,86,35,5,20,35,48,86,73,13,37,14,150,67,83,16,7,87,40,"1500-328"
"1304",1,0,1,1,0,1,1,0,0,0,0,0,4,4,0,4,0,0,0,0,0,0,0,0,0,0,0,0,0,0,0,0,"1100-341"
"1305",12,1,11,7,0,12,9,2,0,1,0,3,68,68,45,23,3,2,15,25,45,36,9,17,7,80,39,41,7,6,55,12,"1250-127"
"1306",69,30,39,57,21,48,62,3,3,0,1,50,271,271,147,124,46,33,63,69,147,114,33,71,24,278,153,125,28,17,169,64,"1200-433"
"1307",42,4,38,28,4,38,40,0,1,0,1,17,224,224,152,71,3,4,11,133,153,122,31,60,25,291,145,146,30,33,190,38,"1150-051"
"1308",24,7,17,17,6,18,24,0,0,0,0,5,92,92,41,51,1,0,11,25,41,27,14,22,9,95,50,45,5,10,56,24,"1100-335"
"1309",16,16,0,16,8,8,1,13,2,0,0,1,16,16,14,2,6,11,13,1,14,7,7,12,4,36,17,19,5,4,16,11,"1400-406"
"1310",8,0,8,5,0,8,1,7,0,0,0,4,56,56,42,14,0,0,12,26,42,34,8,17,7,71,29,42,4,6,32,29,"1200-258"
"1311",23,3,20,14,3,20,20,1,0,2,0,13,142,142,90,52,3,1,25,61,90,72,18,36,11,170,88,82,16,10,113,31,"1250-154"
"1312",8,4,4,6,3,5,1,5,0,0,2,3,44,44,29,15,3,0,8,20,29,27,2,6,2,42,20,22,1,2,28,11,"1250-156"
"1313",21,0,20,17,0,21,7,10,4,0,0,3,208,207,139,68,36,32,58,73,139,105,34,67,28,278,118,160,28,18,163,69,"1170-376"
"1314",16,7,9,14,4,12,5,5,2,4,0,2,82,82,62,20,25,20,28,30,62,35,27,43,23,170,78,92,29,25,74,42,"1250-017"
"1315",13,3,10,10,1,12,5,8,0,0,0,0,52,52,32,20,1,1,12,18,32,23,9,14,6,61,38,23,8,3,38,12,"1200-192"
"1316",43,24,18,35,33,10,41,2,0,0,0,12,127,126,95,31,21,4,14,72,95,72,23,46,19,181,85,96,20,20,104,37,"1100-474"
"1317",6,0,6,6,0,6,1,5,0,0,0,0,78,78,57,21,5,1,12,42,57,46,11,24,6,100,38,62,5,4,57,34,"1150-191"
"1318",17,0,17,15,0,17,5,12,0,0,0,3,128,128,107,21,4,1,63,38,107,64,43,56,29,263,146,117,30,24,178,31,"1170-234"
"1319",23,16,5,23,17,6,0,21,2,0,0,18,78,76,61,15,11,1,2,56,61,52,9,23,8,150,58,92,7,20,60,63,"1170-009"
"1320",65,24,40,59,25,40,43,22,0,0,0,4,343,342,241,101,22,6,106,121,242,179,63,118,42,480,231,249,34,50,304,92,"1150-101"
"1321",6,2,4,3,0,6,3,1,0,0,2,2,33,33,20,13,7,1,8,10,20,16,4,7,3,32,15,17,3,1,20,8,"1050-096"
"1322",18,2,15,11,0,18,9,9,0,0,0,3,121,120,91,29,10,4,37,47,93,58,35,57,28,216,101,115,28,31,128,29,"1150-213"
"1323",0,0,0,0,0,0,0,0,0,0,0,0,0,0,0,0,0,0,0,0,0,0,0,0,0,0,0,0,0,0,0,0,"1099-069"
"1324",23,1,22,19,0,23,14,7,2,0,0,8,159,159,110,49,7,7,61,41,110,89,21,53,25,214,105,109,28,18,128,40,"1150-106"
"1325",29,26,3,29,25,4,0,26,0,3,0,16,50,50,45,5,21,34,39,3,45,24,21,30,17,115,52,63,14,18,59,24,"1070"
"1326",27,2,24,24,5,22,14,13,0,0,0,9,152,151,95,56,7,7,42,48,95,69,26,48,18,219,102,117,27,14,128,50,"1150-040"
"1327",50,11,39,49,13,37,20,19,11,0,0,16,340,340,267,73,69,4,97,162,267,169,98,180,87,622,292,330,92,59,345,126,"1900-028"
"1328",20,18,2,20,6,14,17,0,1,2,0,6,26,26,23,3,2,0,20,1,23,10,13,18,13,67,33,34,13,10,35,9,"1000-300"
"1329",13,0,12,13,0,13,0,13,0,0,0,13,391,390,361,29,208,5,51,293,361,214,147,278,124,955,402,553,156,100,435,264,"1950-157"
"1330",15,15,0,15,12,3,0,12,3,0,0,3,15,15,13,2,2,10,12,1,13,8,5,10,4,37,17,20,7,5,17,8,"1500-618"
"1331",35,2,33,32,1,34,5,26,1,1,2,31,313,313,252,61,16,11,104,128,252,201,51,107,41,463,201,262,36,37,282,108,"1500-098"
"1332",20,5,15,15,6,14,2,7,6,3,2,2,352,352,275,77,134,264,181,67,275,189,86,173,76,603,290,313,74,71,314,144,"1600-134"
"1333",21,2,18,17,2,19,2,18,1,0,0,13,185,184,142,42,5,13,76,57,143,87,56,92,49,345,162,183,61,37,179,68,"1000-151"
"1334",0,0,0,0,0,0,0,0,0,0,0,0,0,0,0,0,0,0,0,0,0,0,0,0,0,0,0,0,0,0,0,0,"1600-100"
"1335",28,7,21,27,28,0,4,24,0,0,0,6,91,91,81,10,11,6,41,34,81,59,22,51,16,168,78,90,13,13,77,65,"1950-234"
"1336",18,1,17,14,0,18,1,17,0,0,0,5,192,192,139,53,26,37,67,56,139,103,36,71,36,282,130,152,29,36,159,58,"1600-205"
"1337",30,1,29,30,1,29,0,28,1,0,1,0,314,314,264,50,39,13,110,127,264,222,42,136,40,478,186,292,36,25,247,170,"1500-464"
"1338",20,16,3,18,16,4,0,18,1,0,1,0,135,135,113,22,67,108,84,13,113,72,41,82,33,284,131,153,56,20,130,78,"1600-134"
"1339",2,0,2,2,0,2,0,0,2,0,0,1,23,23,19,4,7,1,1,18,19,9,10,13,6,54,27,27,10,9,26,9,"1600-198"
"1340",26,0,26,25,0,26,0,0,26,0,0,0,429,429,321,108,177,8,139,174,321,168,153,272,137,867,383,484,103,119,500,145,"1950"
"1341",23,11,12,20,8,15,0,23,0,0,0,1,139,139,113,26,18,8,60,46,113,71,42,61,32,262,115,147,42,19,141,60,"1700-217"
"1342",41,0,41,34,0,41,4,37,0,0,0,19,280,280,204,76,26,5,76,114,204,144,60,106,61,433,181,252,53,57,230,93,"1700-203"
"1343",32,32,0,32,30,2,0,26,3,2,1,6,32,32,24,8,6,19,24,0,24,11,13,19,10,69,38,31,10,10,34,15,"1500-618"
"1344",36,15,21,34,18,18,13,23,0,0,0,22,172,172,129,43,28,31,43,77,129,99,30,76,24,261,128,133,22,19,138,82,"1950-087"
"1345",14,0,14,13,0,14,0,14,0,0,0,1,122,122,90,32,8,1,49,32,90,65,25,46,25,179,81,98,32,10,96,41,"1000-280"
"1346",17,15,2,16,13,4,0,15,0,2,0,1,97,97,76,21,66,71,66,5,76,38,38,65,39,205,99,106,30,32,120,23,"1500-242"
"1347",36,9,27,35,8,28,4,31,0,0,1,4,228,228,155,73,6,2,64,82,155,129,26,77,30,284,125,159,27,19,147,91,"1500-133"
"1348",14,0,14,10,0,14,0,14,0,0,0,4,120,120,99,21,3,2,47,37,99,66,33,60,34,216,98,118,31,26,127,32,"1000-195"
"1349",10,0,10,7,0,10,0,10,0,0,0,0,233,233,180,53,37,11,132,29,180,143,37,89,36,331,138,193,37,14,162,118,"1500-271"
"1350",12,0,12,8,0,12,0,11,1,0,0,1,227,227,181,46,64,75,98,76,181,119,62,104,48,392,162,230,44,43,189,116,"1749-086"
"1351",13,0,13,11,2,11,0,13,0,0,0,7,345,345,295,50,166,2,36,252,295,172,123,237,100,789,374,415,106,89,378,216,"1950-157"
"1352",25,1,24,22,0,25,0,24,1,0,0,13,240,240,216,24,42,6,145,57,216,124,92,137,69,518,249,269,55,62,278,123,"1800-129"
"1353",10,0,10,8,0,10,0,10,0,0,0,6,190,190,171,19,8,3,121,37,171,117,54,102,44,359,172,187,37,34,183,105,"1800-328"
"1354",9,0,9,8,0,9,0,9,0,0,0,4,102,102,81,21,17,2,55,16,81,51,30,49,25,177,80,97,21,22,86,48,"1800"
"1355",1,1,0,1,1,0,0,1,0,0,0,0,1,1,1,0,0,0,0,1,1,1,0,0,0,1,0,1,0,0,0,1,"2680"
"1356",12,6,6,11,6,6,12,0,0,0,0,5,36,36,28,8,2,0,2,24,28,21,7,14,6,55,31,24,4,10,34,7,"1200-293"
"1357",15,6,9,14,4,11,15,0,0,0,0,11,50,50,41,9,3,1,13,25,41,27,14,22,11,103,64,39,13,8,69,13,"1100-256"
"1358",64,64,0,64,64,0,2,55,3,3,1,15,64,64,55,9,9,6,32,20,55,31,24,39,22,140,64,76,27,15,64,34,"1400-081"
"1359",10,3,7,4,1,9,9,0,0,1,0,0,28,28,25,3,1,4,7,18,25,17,8,14,9,56,29,27,11,5,28,12,"1200-293"
"1360",5,1,4,2,0,5,5,0,0,0,0,1,13,13,6,7,0,0,4,2,6,6,0,2,1,8,1,7,1,0,4,3,"1200-249"
"1361",0,0,0,0,0,0,0,0,0,0,0,0,0,0,0,0,0,0,0,0,0,0,0,0,0,0,0,0,0,0,0,0,"1200-470"
"1362",10,7,3,9,7,3,8,2,0,0,0,7,17,17,13,4,1,1,2,9,13,7,6,10,6,56,40,16,6,6,36,8,"1100-471"
"1363",9,4,5,9,2,7,5,2,0,2,0,5,40,40,28,12,6,2,8,18,28,19,9,13,7,55,19,36,9,3,34,9,"1250-020"
"1364",14,0,14,8,0,14,0,14,0,0,0,0,235,235,184,51,15,1,69,103,184,128,56,114,51,397,191,206,56,35,192,114,"1750-200"
"1365",31,19,12,30,21,10,8,13,10,0,0,12,88,88,79,9,53,64,67,12,79,41,38,63,39,208,102,106,35,28,106,39,"1750-200"
"1366",9,9,0,9,2,7,1,0,8,0,0,0,9,9,9,0,1,8,9,0,9,2,7,8,5,31,13,18,6,5,16,4,"1750-123"
"1367",19,17,2,19,19,0,17,1,1,0,0,11,31,31,20,11,1,0,4,14,20,13,7,16,8,50,21,29,8,4,26,12,"1750-025"
"1368",23,0,22,17,0,23,16,4,1,1,1,11,199,198,131,67,20,30,75,45,132,80,52,80,41,307,134,173,50,31,165,61,"1050-097"
"1369",27,23,4,27,18,9,27,0,0,0,0,2,41,41,31,10,7,1,24,5,31,21,10,23,11,73,32,41,11,10,30,22,"1000-197"
"1370",23,21,2,23,17,6,23,0,0,0,0,0,33,33,22,11,5,1,18,2,22,12,10,17,11,62,29,33,18,5,29,10,"1000-159"
"1371",3,0,3,1,0,3,0,0,3,0,0,0,206,206,164,42,146,158,123,24,164,131,33,81,28,309,134,175,30,21,158,100,"1900-386"
"1372",15,1,13,11,1,14,3,12,0,0,0,3,102,101,77,24,14,7,38,26,77,64,13,27,13,142,65,77,17,13,77,35,"1070-064"
"1373",21,1,19,19,0,21,19,2,0,0,0,8,140,139,104,35,6,1,39,56,104,79,25,51,20,248,108,140,14,19,128,87,"1900-179"
"1374",12,0,12,11,0,12,11,1,0,0,0,1,88,88,63,25,5,0,25,32,63,51,12,33,9,118,57,61,8,7,60,43,"1900-179"
"1375",4,0,4,1,0,4,4,0,0,0,0,3,17,17,6,11,0,0,0,6,6,5,1,2,1,10,6,4,1,1,5,3,"1200-290"
"1376",4,4,0,4,4,0,0,4,0,0,0,1,5,5,3,2,0,0,0,1,3,3,0,1,0,4,2,2,0,0,1,3,"1600-251"
"1377",12,2,10,12,0,12,0,12,0,0,0,0,63,63,51,12,0,0,40,7,51,38,13,26,15,99,42,57,16,4,44,35,"1700-331"
"1378",1,1,0,1,1,0,0,1,0,0,0,1,1,1,1,0,0,1,0,0,1,1,0,0,0,1,1,0,0,0,1,0,"1849-001"
"1379",14,0,14,14,0,14,0,6,8,0,0,7,127,127,109,18,4,4,96,6,109,68,41,74,27,253,108,145,26,21,114,92,"1800-245"
"1380",7,0,7,7,0,7,0,7,0,0,0,7,224,224,183,41,129,13,136,23,183,128,55,116,45,381,161,220,39,29,182,131,"1500-023"
"1381",30,0,30,28,0,30,10,17,2,1,0,13,198,198,144,54,18,10,57,69,144,109,35,80,34,281,124,157,26,28,165,62,"1900-104"
"1382",24,3,20,14,5,19,13,11,0,0,0,4,141,140,105,35,16,3,37,54,105,85,20,48,14,206,100,106,9,23,119,55,"1150-115"
"1383",6,0,6,4,0,6,3,2,0,0,1,1,43,43,27,16,2,1,15,8,27,17,10,17,8,61,25,36,8,10,31,12,"1050-091"
"1384",33,33,0,33,33,0,0,26,2,4,1,5,33,33,28,5,6,25,27,0,28,18,10,17,7,62,33,29,9,6,27,20,"1070-079"
"1385",35,20,15,34,20,15,0,23,12,0,0,0,240,240,215,25,108,151,170,35,215,138,77,153,69,497,232,265,35,77,247,138,"1170-105"
"1386",4,0,3,4,1,3,2,2,0,0,0,0,22,21,11,10,2,0,7,3,11,4,7,12,5,45,18,27,10,4,23,8,"1070-012"
"1387",16,3,13,14,3,13,10,5,1,0,0,5,78,78,52,26,1,2,23,27,52,35,17,22,13,107,47,60,13,10,60,24,"1070-280"
"1388",40,3,36,38,0,40,16,24,0,0,0,9,237,236,187,49,10,0,76,99,187,138,49,97,47,385,163,222,46,23,205,111,"1900-104"
"1389",18,3,15,16,2,16,3,11,2,2,0,6,126,126,81,45,4,4,27,44,81,59,22,35,19,155,67,88,15,20,91,29,"1070-036"
"1390",20,0,20,17,0,20,5,12,0,1,2,1,243,243,172,71,32,34,86,69,172,135,37,83,36,332,154,178,42,14,192,84,"1150-192"
"1391",38,30,8,38,30,8,0,37,1,0,0,7,137,137,95,42,14,42,64,19,95,75,20,47,17,180,77,103,14,19,83,64,"1070-079"
"1392",38,36,2,38,37,1,38,0,0,0,0,37,43,43,20,23,4,0,10,10,20,12,8,16,8,50,25,25,9,4,27,10,"1900-439"
"1393",23,0,23,23,1,22,19,4,0,0,0,5,156,156,107,49,2,0,41,60,107,79,28,48,25,212,106,106,32,20,124,36,"1170-230"
"1394",13,3,10,11,0,13,2,8,1,2,0,1,100,100,75,25,17,6,36,34,75,46,29,52,30,186,82,104,31,27,88,40,"1070-051"
"1395",14,2,12,12,1,13,9,5,0,0,0,5,113,113,89,24,0,0,39,42,89,73,16,41,15,156,66,90,10,12,88,46,"1170-163"
"1396",4,1,3,2,0,4,2,0,0,1,1,1,15,15,6,9,0,1,6,0,6,4,2,2,2,10,5,5,1,1,7,1,"1100"
"1397",20,10,9,19,1,19,0,0,20,0,0,13,139,138,115,23,53,53,84,18,115,84,31,79,32,257,122,135,27,25,131,74,"1400-185"
"1398",8,3,5,6,0,8,8,0,0,0,0,6,27,27,15,12,1,0,8,7,15,13,2,9,3,30,17,13,4,3,19,4,"1100-068"
"1399",4,0,4,3,1,3,3,1,0,0,0,1,18,18,11,7,0,0,2,7,11,9,2,4,2,22,10,12,2,6,10,4,"1200-263"
"1400",27,6,21,25,1,26,23,2,0,0,2,6,116,116,67,49,9,10,28,28,67,50,17,31,14,137,64,73,12,20,80,25,"1200-702"
"1401",21,3,18,19,0,21,21,0,0,0,0,12,82,82,57,25,3,0,16,37,57,48,9,23,9,98,48,50,7,9,59,23,"1200"
"1402",0,0,0,0,0,0,0,0,0,0,0,0,0,0,0,0,0,0,0,0,0,0,0,0,0,0,0,0,0,0,0,0,"1100-063"
"1403",0,0,0,0,0,0,0,0,0,0,0,0,0,0,0,0,0,0,0,0,0,0,0,0,0,0,0,0,0,0,0,0,"1100-053"
"1404",36,3,33,35,3,33,15,19,2,0,0,9,217,217,171,46,17,18,75,81,171,123,48,100,42,355,159,196,61,15,185,94,"1250-246"
"1405",21,2,19,16,0,21,18,1,0,1,1,11,98,98,75,23,9,4,25,43,75,59,16,39,13,142,62,80,15,6,80,41,"1250-127"
"1406",13,4,6,8,4,9,12,0,0,1,0,2,53,50,30,20,1,0,11,17,31,21,10,17,5,94,58,36,5,5,68,16,"1100-335"
"1407",25,5,20,17,1,24,20,0,2,0,3,15,135,135,98,37,15,19,31,62,98,83,15,42,15,175,91,84,16,13,101,45,"1249-082"
"1408",23,1,22,20,2,21,2,16,1,2,2,6,166,166,125,41,6,36,67,48,125,91,34,70,38,248,108,140,28,23,145,52,"1350-149"
"1409",24,3,21,18,3,21,23,0,0,1,0,3,131,131,70,61,3,1,27,41,70,55,15,34,18,136,65,71,18,12,72,34,"1250-124"
"1410",17,0,17,14,0,17,6,8,3,0,0,0,196,196,156,40,45,73,89,53,156,115,41,82,35,319,138,181,31,25,185,78,"1150-045"
"1411",10,0,9,4,0,10,4,5,1,0,0,0,91,91,61,30,18,5,12,44,61,42,19,32,19,134,61,73,19,22,61,32,"1050-016"
"1412",18,13,5,18,12,6,1,10,0,3,4,12,62,62,42,20,3,1,25,11,42,33,9,20,4,76,40,36,3,4,48,21,"1070"
"1413",59,1,56,57,2,57,47,11,1,0,0,13,480,478,351,127,21,7,163,170,352,255,97,203,89,739,345,394,77,71,417,174,NA
"1414",16,2,14,14,1,15,9,7,0,0,0,2,119,119,95,24,5,0,43,47,95,71,24,51,24,208,96,112,22,18,132,36,"1150-105"
"1415",54,21,33,46,21,33,26,22,3,3,0,7,237,237,191,46,23,26,70,110,191,132,59,109,53,389,168,221,47,38,218,86,"1070-137"
"1416",30,26,4,29,29,1,24,3,1,1,1,21,40,40,19,21,10,3,6,12,19,17,2,13,2,38,19,19,3,1,13,21,"1600-515"
"1417",24,0,24,22,0,24,0,24,0,0,0,0,208,208,163,45,14,1,124,28,163,110,53,95,45,356,171,185,41,24,212,79,"1800-071"
"1418",10,6,4,10,5,5,1,3,6,0,0,0,29,29,23,6,1,7,6,13,23,11,12,17,13,65,26,39,17,11,32,5,"2680"
"1419",11,11,0,11,11,0,0,2,2,7,0,4,31,31,3,8,0,0,3,0,23,17,6,14,11,57,28,29,15,7,29,6,"2680"
"1420",0,0,0,0,0,0,0,0,0,0,0,0,0,0,0,0,0,0,0,0,0,0,0,0,0,0,0,0,0,0,0,0,"1990-514"
"1421",42,34,8,39,32,10,41,0,0,0,1,18,63,63,45,18,10,7,19,22,45,40,5,20,8,82,39,43,11,8,38,25,"1600-188"
"1422",11,1,10,9,0,11,0,9,2,0,0,0,241,241,179,60,96,108,135,30,181,128,53,104,44,386,171,215,48,38,153,147,"1750-144"
"1423",35,35,0,35,27,8,4,26,1,2,2,6,37,37,31,6,8,27,22,0,31,21,10,22,10,68,29,39,9,6,32,21,"1800-192"
"1424",48,48,0,48,48,0,0,0,48,0,0,15,48,48,45,3,21,2,23,6,45,23,22,38,16,124,71,53,13,19,57,35,"1900-240"
"1425",26,1,25,23,1,25,4,21,1,0,0,6,223,223,184,39,41,34,89,84,184,136,48,110,45,388,181,207,40,33,212,103,"1900-386"
"1426",0,0,0,0,0,0,0,0,0,0,0,0,0,0,0,0,0,0,0,0,0,0,0,0,0,0,0,0,0,0,0,0,"1049-001"
"1427",31,2,29,23,2,29,1,19,6,5,0,13,246,246,179,67,43,23,104,58,179,109,70,116,64,418,191,227,63,48,227,80,"1050-070"
"1428",5,0,5,3,0,5,0,3,2,0,0,5,207,207,166,41,63,2,118,36,166,108,58,116,39,383,190,193,30,43,204,106,"1950-002"
"1429",15,0,15,14,0,15,0,6,7,2,0,5,201,201,170,30,64,126,126,29,171,126,45,108,45,348,154,194,30,41,170,107,"1500-112"
"1430",23,23,0,23,18,5,0,23,0,0,0,4,23,23,23,0,10,22,20,0,23,14,9,15,8,55,27,28,10,3,20,22,"1700-135"
"1431",32,8,24,24,9,23,26,5,0,0,1,16,160,160,105,55,9,8,36,63,105,81,24,51,21,216,100,116,22,17,135,42,"1169-050"
"1432",3,0,3,2,0,3,2,0,0,0,1,1,27,27,5,22,1,2,0,4,5,4,1,3,0,10,5,5,0,0,7,3,"1250-167"
"1433",35,35,0,35,35,0,0,35,0,0,0,23,36,36,19,17,6,0,9,8,19,12,7,14,4,47,25,22,8,3,27,9,"1070"
"1434",16,0,16,15,0,16,0,13,2,1,0,3,173,173,137,36,37,54,69,55,137,87,50,88,38,312,150,162,32,27,175,78,"1900-046"
"1435",22,2,20,19,2,20,12,5,2,0,3,4,234,234,162,72,31,25,58,86,162,121,41,86,34,335,172,163,28,46,195,66,"1150-137"
"1436",6,0,6,4,0,6,0,0,6,0,0,0,114,114,81,33,56,70,50,19,81,62,19,51,15,174,86,88,24,11,81,58,"1250-041"
"1437",2,1,1,2,0,2,1,1,0,0,0,0,5,5,5,0,1,0,1,4,5,3,2,4,2,13,6,7,4,1,8,0,"1150-034"
"1438",6,0,6,6,0,6,0,0,6,0,0,0,108,108,98,10,6,4,80,9,98,58,40,76,23,238,106,132,27,13,116,82,"1070"
"1439",4,0,4,3,0,4,3,1,0,0,0,1,29,29,27,1,1,1,6,18,28,23,5,13,6,55,23,32,7,4,36,8,"1170-132"
"1440",25,9,16,21,10,15,15,6,2,2,0,1,85,85,49,35,3,3,22,24,50,38,12,24,8,103,60,43,7,5,69,22,"1150-034"
"1441",20,2,17,14,1,19,14,4,0,2,0,4,130,130,66,64,7,4,33,22,66,45,21,33,15,139,79,60,19,9,82,29,"1150-005"
"1442",13,0,13,11,1,12,11,2,0,0,0,5,93,93,70,23,2,2,15,53,70,46,24,45,25,190,103,87,29,13,121,27,"1170-998"
"1443",19,1,18,12,1,18,17,1,0,0,1,4,213,213,140,73,15,20,36,91,140,119,21,65,20,247,116,131,21,13,138,75,"1150-215"
"1444",0,0,0,0,0,0,0,0,0,0,0,0,0,0,0,0,0,0,0,0,0,0,0,0,0,0,0,0,0,0,0,0,"1950-408"
"1445",29,22,7,29,19,10,4,24,0,0,1,21,53,53,29,24,9,0,7,18,29,22,7,20,5,61,29,32,4,6,37,14,"1070-221"
"1446",17,0,17,16,0,17,12,2,0,3,0,10,116,116,83,33,24,25,21,57,83,61,22,50,16,175,73,102,18,11,67,79,"1900-172"
"1447",12,2,10,12,2,10,2,10,0,0,0,1,76,76,62,14,0,0,27,31,62,40,22,39,17,137,60,77,15,14,73,35,"1900-381"
"1448",19,2,17,15,1,18,8,10,0,0,1,16,138,138,108,30,22,23,47,43,108,84,24,54,18,215,93,122,13,20,133,49,"1900-172"
"1449",12,0,12,10,0,12,7,5,0,0,0,11,128,128,100,28,10,0,36,55,100,68,32,52,25,207,97,110,19,21,114,53,"1900-182"
"1450",16,0,16,15,0,16,14,2,0,0,0,6,142,142,95,47,9,4,46,40,95,69,26,49,18,195,83,112,17,21,98,59,"1900-999"
"1451",11,0,11,11,0,11,7,4,0,0,0,5,104,104,65,39,1,2,40,22,65,41,24,37,19,148,67,81,11,25,76,36,"1900-183"
"1452",13,0,13,11,0,13,4,9,0,0,0,6,125,125,71,54,9,0,22,47,71,48,23,40,20,161,68,93,27,15,97,22,"1900-183"
"1453",15,1,14,11,1,14,4,7,1,1,2,8,145,145,120,25,20,12,57,55,120,79,41,73,38,280,128,152,41,34,155,50,"1048-017"
"1454",18,4,13,15,4,14,11,2,1,0,4,9,131,130,79,51,30,34,31,39,80,55,25,49,21,172,78,94,14,20,108,30,"1070-045"
"1455",10,0,10,8,0,10,0,8,2,0,0,0,261,261,197,64,65,153,161,18,197,153,44,113,31,394,185,209,25,30,172,167,"1900-386"
"1456",26,1,25,22,0,26,7,15,2,1,1,7,218,218,183,35,36,35,101,65,183,126,57,108,47,401,183,218,54,30,210,107,"1050-103"
"1457",21,3,18,20,4,17,5,16,0,0,0,10,108,108,78,30,6,2,17,55,78,56,22,43,17,163,67,96,22,8,103,30,"1950-049"
"1458",16,15,1,16,16,0,0,16,0,0,0,2,19,19,15,4,2,0,0,15,15,11,4,6,2,26,16,10,2,1,13,10,"1900-278"
"1459",24,22,2,24,15,9,24,0,0,0,0,0,30,30,21,9,3,4,15,2,21,11,10,16,11,56,30,26,7,12,32,5,"1000-197"
"1460",35,23,12,34,26,9,0,34,0,0,1,9,110,110,74,36,2,0,20,51,74,58,16,46,18,158,76,82,16,20,89,33,"1900-381"
"1461",8,1,7,7,1,7,0,8,0,0,0,2,99,99,77,22,11,2,32,35,77,55,22,39,21,169,80,89,36,11,78,44,"1249-024"
"1462",28,17,11,27,10,18,1,21,5,1,0,15,91,91,58,33,10,12,18,29,58,38,20,29,16,132,61,71,16,15,75,26,"1449-028"
"1463",10,2,8,9,1,9,8,2,0,0,0,9,44,44,30,14,0,2,9,19,30,21,9,15,6,73,42,31,8,8,38,19,"1200-056"
"1464",25,2,22,15,1,24,24,0,0,1,0,20,128,128,81,47,4,2,7,67,81,64,17,35,13,151,86,65,10,13,106,22,"1100-112"
"1465",8,1,7,1,0,8,8,0,0,0,0,0,26,26,13,13,0,0,3,10,13,9,4,7,4,26,11,15,2,2,16,6,"1200-085"
"1466",17,3,14,13,1,16,12,3,1,1,0,5,60,60,39,21,0,0,17,19,39,33,6,13,4,69,34,35,3,3,43,20,"1200-163"
"1467",18,12,6,18,5,13,0,0,2,13,3,2,55,55,46,9,35,30,35,5,46,27,19,29,19,112,53,59,21,14,54,23,"1400-188"
"1468",12,1,11,8,0,12,12,0,0,0,0,5,77,77,49,28,4,2,27,18,49,40,9,25,12,90,43,47,9,11,47,23,"1100-521"
"1469",20,10,10,18,5,15,4,15,0,0,1,12,60,60,50,10,11,24,32,13,50,30,20,35,22,137,67,70,25,25,56,31,"1200-792"
"1470",4,0,4,2,0,4,0,4,0,0,0,2,25,25,13,12,0,0,2,11,13,7,6,6,4,33,19,14,4,3,23,3,"1100-350"
"1471",6,0,6,4,0,6,0,0,6,0,0,5,65,65,60,5,42,1,9,50,60,35,25,49,27,165,79,86,26,29,80,30,"1675-161"
"1472",6,6,0,6,5,1,0,6,0,0,0,2,6,6,5,1,1,5,5,0,5,3,2,4,3,14,5,9,5,1,5,3,"1849-029"
"1473",46,45,1,46,12,34,0,45,1,0,0,11,50,50,37,13,14,29,31,5,37,22,15,27,13,94,48,46,14,9,46,25,"1800-364"
"1474",4,0,4,4,0,4,0,4,0,0,0,1,72,72,66,6,2,0,45,16,66,43,23,44,22,145,69,76,14,17,76,38,"1800-048"
"1475",6,0,6,6,0,6,0,6,0,0,0,4,107,107,91,16,1,1,66,16,91,73,18,56,17,181,87,94,9,17,88,67,"1800-048"
"1476",15,0,15,15,0,15,0,0,15,0,0,5,90,90,86,4,27,2,9,76,86,32,54,85,38,270,121,149,45,29,150,46,"1600-647"
"1477",0,0,0,0,0,0,0,0,0,0,0,0,0,0,0,0,0,0,0,0,0,0,0,0,0,0,0,0,0,0,0,0,"1600-003"
"1478",20,20,0,20,2,18,0,1,14,5,0,6,20,20,18,2,7,12,17,0,18,8,10,12,8,50,30,20,5,12,22,11,"1849-029"
"1479",47,47,0,47,31,16,0,47,0,0,0,15,48,48,44,4,10,38,35,3,44,23,21,36,21,118,62,56,23,11,61,23,"1800-364"
"1480",15,0,15,14,0,15,0,0,14,1,0,1,252,252,224,28,179,218,201,13,224,109,115,181,108,593,286,307,80,102,321,90,"1649-020"
"1481",6,0,6,5,0,6,0,0,4,2,0,0,149,149,119,30,84,118,71,37,119,73,46,77,56,263,129,134,62,20,176,5,"1600-067"
"1482",3,1,2,3,1,2,0,2,1,0,0,2,28,28,21,7,2,0,0,19,21,13,8,14,6,47,20,27,6,4,23,14,"1800-033"
"1483",11,0,11,10,0,11,0,0,11,0,0,0,108,108,82,26,73,82,66,10,82,55,27,61,32,189,87,102,24,24,119,22,"1600-067"
"1484",43,42,1,43,18,25,5,18,6,12,2,3,45,45,42,3,15,39,34,3,42,21,21,35,17,109,45,64,12,14,52,31,"1800-362"
"1485",19,0,19,18,0,19,0,6,0,13,0,6,250,250,193,57,149,142,148,28,193,113,80,136,76,482,218,264,77,62,250,93,"1750-232"
"1486",14,9,5,14,11,3,0,11,3,0,0,12,29,29,20,9,2,0,0,19,20,17,3,11,1,36,13,23,1,2,13,20,"1750-161"
"1487",6,0,6,6,0,6,0,0,3,3,0,0,178,178,148,30,137,145,119,11,148,94,54,103,47,347,151,196,35,46,178,88,"1750-155"
"1488",42,27,15,39,29,13,38,4,0,0,0,25,94,94,57,37,5,0,18,37,57,41,16,33,16,116,62,54,15,14,64,23,"1170-376"
"1489",10,3,7,8,3,7,9,1,0,0,0,9,48,48,28,20,0,2,4,20,28,20,8,17,6,63,32,31,6,5,37,15,"1170-165"
"1490",30,11,19,26,10,20,12,15,2,1,0,15,112,112,68,44,12,14,33,31,68,51,17,34,19,135,61,74,18,16,72,29,"1150-268"
"1491",30,1,29,21,4,26,13,16,0,0,1,21,256,256,177,79,15,9,94,70,177,142,35,75,26,327,161,166,27,20,178,102,"1170-165"
"1492",37,16,21,28,15,22,37,0,0,0,0,15,134,134,94,40,2,8,24,63,94,71,23,42,16,182,86,96,17,18,106,41,"1170-384"
"1493",14,1,13,10,0,14,11,2,0,0,1,4,52,52,32,20,0,7,14,13,32,29,3,12,3,53,23,30,6,2,32,13,"1200-192"
"1494",9,8,1,9,8,1,4,4,1,0,0,5,20,20,16,4,3,2,11,5,16,9,7,11,3,38,18,20,5,2,13,18,"1400-406"
"1495",47,21,26,42,26,21,32,12,2,1,0,30,214,214,173,41,16,1,62,96,173,127,46,92,46,336,140,196,49,22,186,79,"1350-039"
"1496",23,0,23,20,0,23,23,0,0,0,0,8,186,186,141,45,3,26,44,87,141,77,64,100,59,366,173,193,85,36,184,61,"1350-037"
"1497",18,8,10,17,1,17,0,16,0,1,1,7,64,64,49,15,5,9,29,18,49,32,17,34,20,110,44,66,19,12,48,31,"1400-406"
"1498",18,1,17,17,0,18,11,6,0,1,0,5,124,124,99,25,0,3,53,37,99,72,27,67,30,212,100,112,29,15,122,46,"1350-034"
"1499",16,0,16,12,0,16,2,10,2,0,2,10,146,146,112,34,20,18,65,43,112,64,48,71,44,272,124,148,58,28,128,58,"1350-322"
"1500",19,2,17,12,2,17,0,15,4,0,0,12,122,122,90,32,25,16,38,46,90,61,29,48,29,197,83,114,34,26,88,49,"1350-321"
"1501",42,33,9,42,33,9,32,1,9,0,0,28,239,239,206,33,102,8,4,195,206,113,93,149,81,515,241,274,76,75,273,91,"1300-125"
"1502",17,1,14,12,0,17,0,14,3,0,0,14,128,125,103,22,30,22,60,30,103,72,31,61,30,254,112,142,42,22,121,69,"1350-133"
"1503",17,0,17,13,0,17,14,2,1,0,0,2,115,115,85,30,10,9,49,30,85,48,37,64,35,215,99,116,44,21,114,36,"1250-151"
"1504",20,5,15,18,7,13,0,17,3,0,0,7,132,132,101,31,18,17,41,56,101,76,25,48,22,201,94,107,27,12,112,50,"1250-088"
"1505",28,0,26,18,0,28,2,23,1,2,0,27,212,211,156,55,21,41,76,66,157,109,48,87,33,351,165,186,33,34,193,91,"1170-210"
"1506",20,0,20,15,0,20,19,1,0,0,0,12,146,146,112,34,1,0,59,40,112,79,33,61,29,244,111,133,31,27,145,41,"1170-132"
"1507",26,21,5,25,22,4,1,24,0,1,0,22,87,87,56,31,15,11,31,16,56,41,15,33,18,118,55,63,18,11,61,28,"1070-221"
"1508",17,9,8,15,10,7,14,3,0,0,0,5,122,122,91,31,19,39,66,15,91,71,20,49,19,175,83,92,19,12,102,42,"1900-046"
"1509",14,6,7,14,5,9,0,6,4,4,0,10,148,147,123,23,24,91,75,41,124,55,69,92,73,365,178,187,87,52,209,17,"1750-462"
"1510",1,0,1,0,0,1,0,0,0,1,0,0,35,35,32,3,31,32,0,32,32,18,14,19,14,76,41,35,17,8,51,0,"1990-514"
"1511",19,0,19,17,0,19,0,0,0,19,0,19,115,115,97,18,3,8,5,84,97,51,46,75,50,276,124,152,79,35,129,33,"1750-462"
"1512",8,0,8,8,0,8,0,0,0,8,0,8,129,129,113,16,26,113,82,25,113,48,65,92,71,311,143,168,93,24,188,6,"1750-478"
"1513",10,5,5,10,7,3,0,9,1,0,0,10,53,53,47,6,1,6,2,45,47,21,26,35,27,141,70,71,33,26,73,9,"1750-111"
"1514",55,51,4,55,50,5,0,51,2,1,1,53,88,88,64,24,10,5,3,58,64,40,24,38,21,153,70,83,25,21,78,29,"1750-478"
"1515",38,10,26,36,15,23,13,18,4,2,1,8,343,341,261,80,88,121,151,83,262,183,79,153,68,567,261,306,53,57,306,151,"1900-040"
"1516",7,0,7,4,2,5,2,5,0,0,0,0,40,40,23,17,5,5,8,13,23,14,9,17,6,59,28,31,4,5,44,6,"1150-282"
"1517",0,0,0,0,0,0,0,0,0,0,0,0,0,0,0,0,0,0,0,0,0,0,0,0,0,0,0,0,0,0,0,0,"1250-160"
"1518",32,3,29,24,3,29,14,14,2,1,1,7,318,318,205,113,25,36,67,118,205,167,38,104,31,379,170,209,28,23,234,94,"1071-811"
"1519",11,11,0,11,11,0,7,3,0,1,0,8,12,12,8,4,0,0,2,6,8,6,2,5,1,16,6,10,3,0,8,5,"1070-079"
"1520",18,1,17,9,1,17,14,2,1,1,0,7,110,110,63,47,6,0,38,20,63,46,17,30,12,124,55,69,9,14,74,27,"1150-291"
"1521",4,1,3,2,1,3,1,3,0,0,0,2,23,23,19,4,2,1,12,7,19,13,6,11,4,39,20,19,2,4,21,12,"1300-125"
"1522",22,4,18,21,5,17,16,3,1,2,0,7,119,119,80,39,6,4,18,61,80,62,18,43,16,163,78,85,21,16,83,43,"1170-009"
"1523",9,9,0,9,7,2,2,5,0,2,0,6,10,10,7,3,1,0,0,6,7,6,1,3,1,12,5,7,0,1,9,2,"1070-079"
"1524",0,0,0,0,0,0,0,0,0,0,0,0,0,0,0,0,0,0,0,0,0,0,0,0,0,0,0,0,0,0,0,0,"1070-046"
"1525",29,13,16,29,14,15,19,8,2,0,0,16,158,158,117,41,11,5,27,82,117,82,35,67,28,244,98,146,18,26,141,59,"1170-009"
"1526",8,6,2,8,4,4,7,1,0,0,0,7,18,18,9,8,0,0,1,1,10,5,5,5,2,26,19,7,5,1,19,1,"1169-091"
"1527",31,0,31,25,0,31,26,5,0,0,0,14,173,173,140,33,3,0,62,71,140,94,46,83,35,328,158,170,38,28,204,58,"1170-245"
"1528",15,13,2,15,14,1,14,1,0,0,0,10,19,19,12,7,1,1,2,9,12,9,3,9,2,30,15,15,5,3,17,5,"1070-079"
"1529",14,1,13,10,0,14,7,7,0,0,0,5,146,146,114,32,13,2,13,95,114,74,40,66,39,269,124,145,43,35,137,54,"1099-034"
"1530",20,0,20,16,0,20,19,1,0,0,0,8,134,134,90,44,3,9,41,43,90,58,32,51,21,214,97,117,15,17,132,50,"1170-134"
"1531",12,12,0,12,7,5,6,3,1,2,0,7,15,15,11,4,0,2,4,7,11,7,4,7,3,26,16,10,2,1,20,3,"1070-079"
"1532",32,7,24,31,4,28,12,15,3,2,0,6,171,170,123,47,1,3,44,69,124,97,27,65,25,236,116,120,19,24,143,50,"1070-221"
"1533",40,0,40,33,1,39,2,34,2,2,0,24,348,348,256,92,23,25,128,106,256,198,58,139,48,503,233,270,41,37,287,138,"1170-998"
"1534",3,0,3,1,0,3,3,0,0,0,0,0,25,25,14,11,1,0,7,7,14,11,3,8,4,31,14,17,4,4,22,1,"1170-021"
"1535",16,1,15,10,1,15,9,7,0,0,0,0,107,107,73,34,3,1,23,46,73,58,15,37,14,161,72,89,17,15,90,39,"1150-010"
"1536",34,6,28,33,10,24,18,1,7,8,0,16,253,253,204,49,72,40,71,121,204,137,67,122,62,442,208,234,64,42,236,100,"1070"
"1537",12,0,11,9,0,12,12,0,0,0,0,0,77,76,49,27,3,0,19,25,50,33,17,26,13,116,57,59,13,9,78,16,"1150-040"
"1538",48,29,19,48,37,11,37,7,2,1,1,31,142,142,98,44,9,5,46,40,98,63,35,63,30,222,100,122,33,22,126,41,"1070-221"
"1539",21,0,21,21,0,21,0,0,21,0,0,7,212,212,197,15,171,13,6,187,197,88,109,175,91,588,289,299,112,73,308,95,"1950-347"
"1540",2,2,0,2,2,0,0,2,0,0,0,0,3,3,2,1,0,1,1,1,2,2,0,0,0,2,0,2,0,0,1,1,"1900-330"
"1541",5,0,5,5,0,5,1,0,0,4,0,0,56,56,45,11,38,41,37,7,45,27,18,31,17,103,52,51,13,13,60,17,"1900-032"
"1542",27,4,22,23,5,22,2,23,2,0,0,14,186,185,122,63,9,9,41,72,122,98,24,54,21,249,117,132,20,18,146,65,"1050-222"
"1543",21,1,20,18,2,19,5,12,3,1,0,2,255,255,214,41,38,57,109,85,214,156,58,127,44,443,204,239,39,44,226,134,"1900-381"
"1544",8,4,4,7,6,2,8,0,0,0,0,0,19,19,12,7,0,2,9,3,12,11,1,5,1,18,7,11,0,2,10,6,"1000-300"
"1545",8,0,8,8,0,8,4,2,2,0,0,2,70,70,60,10,1,6,9,50,60,46,14,26,5,123,65,58,8,6,81,28,"1900-221"
"1546",0,0,0,0,0,0,0,0,0,0,0,0,0,0,0,0,0,0,0,0,0,0,0,0,0,0,0,0,0,0,0,0,"1675-632"
"1547",30,18,12,28,21,9,3,23,4,0,0,6,101,101,88,13,20,33,35,40,88,55,33,59,27,211,105,106,26,35,109,41,"1750-314"
"1548",13,11,2,12,13,0,0,13,0,0,0,5,21,21,16,5,3,5,5,7,16,13,3,11,5,30,14,16,2,5,13,10,"1800-281"
"1549",15,0,15,15,0,15,0,0,15,0,0,2,368,368,336,32,234,0,12,308,336,152,184,285,169,1047,505,542,200,152,542,153,"1750-186"
"1550",5,0,5,5,0,5,0,0,0,5,0,0,50,50,45,5,44,45,33,7,45,28,17,29,20,107,47,60,17,21,46,23,"1990-370"
"1551",0,0,0,0,0,0,0,0,0,0,0,0,0,0,0,0,0,0,0,0,0,0,0,0,0,0,0,0,0,0,0,0,"1750-416"
"1552",11,0,11,11,0,11,0,0,0,11,0,0,154,154,135,19,130,135,127,7,135,40,95,119,91,416,203,213,89,72,219,36,"1990-099"
"1553",6,0,6,6,0,6,0,0,6,0,0,1,212,212,199,13,151,3,33,160,199,98,101,175,87,559,277,282,84,72,311,92,"1750-186"
"1554",66,42,24,64,42,24,0,66,0,0,0,5,268,268,216,52,29,34,181,22,216,155,61,146,59,481,222,259,66,43,236,136,"1849-028"
"1555",44,44,0,44,39,5,18,4,4,11,7,8,44,44,38,6,15,30,36,1,38,22,16,27,14,91,41,50,10,9,49,23,"1800-111"
"1556",16,4,12,14,4,12,5,11,0,0,0,16,145,145,120,25,5,1,34,72,120,91,29,61,21,244,97,147,23,22,124,75,"1750-161"
"1557",6,0,6,6,0,6,0,0,0,6,0,0,143,143,118,25,114,118,102,14,118,56,62,93,67,328,161,167,60,59,176,33,"1990-427"
"1558",9,6,3,7,1,8,2,4,0,3,0,9,70,70,53,17,28,50,49,2,53,31,22,30,17,121,50,71,12,10,58,41,"1750-161"
"1559",6,0,6,5,0,6,0,0,5,1,0,0,63,63,50,13,29,49,43,6,50,31,19,36,16,120,63,57,17,13,61,29,"1990-237"
"1560",13,0,13,10,2,11,0,13,0,0,0,2,217,217,157,60,24,8,95,49,157,128,29,76,22,279,128,151,21,10,152,96,"1800-281"
"1561",7,0,7,4,0,7,0,1,3,3,0,2,294,294,239,55,187,234,157,62,239,157,82,139,86,519,242,277,97,53,312,57,"1750-230"
"1562",10,0,10,0,0,10,0,0,0,1,9,0,316,316,240,76,228,240,178,52,240,182,58,129,65,474,236,238,83,23,348,20,"1750-220"
"1563",7,0,7,7,0,7,0,7,0,0,0,7,140,140,99,41,12,4,14,79,99,47,52,87,45,298,143,155,49,32,144,73,"1750-220"
"1564",7,0,7,4,0,7,0,7,0,0,0,0,277,277,240,37,179,1,174,53,240,165,75,151,61,511,223,288,56,40,243,172,"1800-281"
"1565",10,0,10,10,0,10,0,0,0,10,0,0,139,139,120,19,113,120,99,19,120,56,64,95,65,332,162,170,73,49,183,27,"1990-099"
"1566",23,1,22,18,0,23,2,21,0,0,0,8,185,185,135,50,4,8,44,80,135,110,25,64,27,250,99,151,27,21,138,64,"1749-074"
"1567",27,1,26,18,1,26,6,21,0,0,0,15,212,212,128,84,4,2,38,82,128,107,21,55,22,226,91,135,20,21,134,51,"1600-198"
"1568",25,1,24,23,2,23,10,14,0,1,0,0,264,264,216,48,49,6,50,156,216,161,55,128,51,443,189,254,53,35,204,151,"1500-133"
"1569",32,1,31,26,1,31,0,30,1,1,0,3,423,423,331,92,83,154,173,127,331,239,92,191,83,674,280,394,82,44,336,212,"1500-197"
"1570",2,1,1,2,2,0,1,1,0,0,0,1,6,6,3,3,0,0,0,2,3,3,0,1,0,5,2,3,0,0,5,0,"1950-278"
"1571",5,0,5,5,0,5,0,5,0,0,0,0,86,86,67,19,2,0,48,14,67,49,18,35,13,133,60,73,17,7,70,39,"1500-377"
"1572",2,1,1,2,1,1,2,0,0,0,0,2,4,4,2,2,0,0,0,2,2,2,0,1,0,3,1,2,0,0,1,2,"1200-421"
"1573",4,1,3,3,0,4,1,1,2,0,0,0,20,20,11,9,0,0,0,11,11,7,4,5,3,23,14,9,3,4,13,3,NA
"1574",4,1,3,2,0,4,0,1,3,0,0,2,13,13,6,7,1,0,2,4,6,6,0,1,0,7,5,2,0,0,6,1,"1100-240"
"1575",26,16,10,26,20,6,3,18,5,0,0,25,68,68,48,20,3,10,16,26,48,34,14,24,9,101,38,63,12,7,62,20,"1300-070"
"1576",41,8,33,25,17,24,17,24,0,0,0,15,171,171,94,77,3,10,28,61,94,69,25,44,16,190,95,95,18,16,116,40,"1100-004"
"1577",61,41,20,56,31,30,42,17,0,0,2,41,158,158,98,60,4,2,16,80,98,73,25,48,17,197,108,89,14,24,122,37,"1100-219"
"1578",35,13,22,32,12,23,32,2,1,0,0,17,158,158,109,49,2,7,17,89,109,75,34,68,33,253,113,140,35,26,125,67,"1200-821"
"1579",0,0,0,0,0,0,0,0,0,0,0,0,0,0,0,0,0,0,0,0,0,0,0,0,0,0,0,0,0,0,0,0,"1100-199"
"1580",30,9,21,29,5,25,21,3,2,2,2,19,114,114,84,30,18,17,37,40,84,66,18,40,19,157,64,93,20,14,82,41,"1350-183"
"1581",0,0,0,0,0,0,0,0,0,0,0,0,0,0,0,0,0,0,0,0,0,0,0,0,0,0,0,0,0,0,0,0,"1400-195"
"1582",4,4,0,4,3,1,0,4,0,0,0,1,4,4,3,1,1,3,3,0,3,3,0,3,0,6,3,3,0,0,4,2,"1400-406"
"1583",27,6,21,23,6,21,24,2,1,0,0,10,147,147,101,46,7,14,30,67,101,60,41,50,23,287,194,93,23,24,200,40,"1100-376"
"1584",11,11,0,11,6,5,0,7,0,4,0,0,12,12,9,3,2,4,9,0,9,3,6,9,5,27,13,14,3,5,11,8,"1400-406"
"1585",15,15,0,15,3,12,1,13,0,1,0,5,15,15,11,4,2,6,10,1,11,6,5,8,5,26,16,10,7,1,15,3,"1400-406"
"1586",25,25,0,25,19,6,5,18,0,1,1,9,25,25,23,2,5,14,16,4,23,16,7,15,7,52,22,30,7,10,22,13,"1400-406"
"1587",69,7,61,63,0,69,30,28,6,5,0,20,570,568,439,129,38,24,174,234,439,330,109,226,79,924,432,492,77,79,574,194,"1150-258"
"1588",23,23,0,23,21,2,0,23,0,0,0,9,23,23,20,3,6,12,17,3,20,11,9,14,6,53,26,27,3,5,28,17,"1900-330"
"1589",55,39,16,51,50,5,41,14,0,0,0,53,138,138,92,46,10,2,10,74,92,63,29,53,32,204,91,113,39,25,97,43,"1070-181"
"1590",23,0,23,17,0,23,7,14,0,1,1,1,225,225,160,65,5,8,86,59,160,111,49,84,38,345,149,196,38,29,197,81,"1170-315"
"1591",22,22,0,22,9,13,0,20,0,0,2,0,22,22,18,4,6,12,17,1,18,12,6,12,6,43,21,22,6,5,22,10,"1900-311"
"1592",15,0,15,14,0,15,0,15,0,0,0,1,189,189,129,60,7,2,63,58,129,101,28,71,25,253,109,144,22,18,134,79,"1170-315"
"1593",18,1,17,17,0,18,7,4,4,1,2,1,138,138,111,27,35,37,51,55,111,76,35,58,28,230,106,124,33,26,135,36,"1050-129"
"1594",32,20,12,32,28,4,22,10,0,0,0,32,92,92,71,21,4,0,2,67,71,55,16,35,17,134,64,70,25,8,67,34,"1070-181"
"1595",12,0,12,9,0,12,0,0,12,0,0,12,128,128,118,10,57,9,18,90,118,40,78,103,74,423,200,223,117,77,198,31,"1750-462"
"1596",11,5,6,10,7,4,0,3,8,0,0,9,41,41,35,6,1,4,9,24,35,18,17,26,14,94,50,44,17,16,50,11,"1750-462"
"1597",14,0,14,10,0,14,0,8,3,3,0,2,139,139,101,38,27,52,43,50,101,72,29,57,28,211,95,116,34,18,127,32,"1750-181"
"1598",0,0,0,0,0,0,0,0,0,0,0,0,0,0,0,0,0,0,0,0,0,0,0,0,0,0,0,0,0,0,0,0,"1990-273"
"1599",7,0,7,7,0,7,0,0,0,7,0,0,117,117,89,28,89,89,65,17,89,63,26,56,29,190,83,107,25,22,106,37,"1990-155"
"1600",0,0,0,0,0,0,0,0,0,0,0,0,0,0,0,0,0,0,0,0,0,0,0,0,0,0,0,0,0,0,0,0,"1990-102"
"1601",27,24,3,26,27,0,26,1,0,0,0,10,38,38,27,11,3,2,12,12,27,21,6,14,8,51,28,23,8,5,27,11,"1800-056"
"1602",31,22,9,27,23,8,23,0,0,8,0,13,243,243,178,65,138,159,114,51,178,122,56,94,65,389,188,201,91,33,231,34,"1800-056"
"1603",18,18,0,18,18,0,0,16,2,0,0,11,21,21,17,4,6,4,11,3,17,8,9,17,3,53,30,23,6,1,32,14,"1700-029"
"1604",0,0,0,0,0,0,0,0,0,0,0,0,0,0,0,0,0,0,0,0,0,0,0,0,0,0,0,0,0,0,0,0,"1849-003"
"1605",6,0,6,5,0,6,0,6,0,0,0,5,149,149,131,18,80,1,83,36,131,81,50,86,38,316,153,163,29,35,177,75,"1800-119"
"1606",1,1,0,1,1,0,0,1,0,0,0,1,1,1,1,0,0,0,0,0,1,1,0,0,0,2,2,0,0,1,1,0,"1800-328"
"1607",13,0,13,13,0,13,0,9,4,0,0,8,278,278,240,38,182,8,87,142,240,170,70,148,49,516,248,268,39,42,269,166,"1800-245"
"1608",3,0,3,3,0,3,0,3,0,0,0,0,89,89,71,18,46,2,53,9,71,59,12,36,13,127,52,75,12,12,67,36,"1600-646"
"1609",16,1,15,13,0,16,1,7,8,0,0,10,292,292,239,53,73,168,160,47,239,161,78,145,61,520,234,286,59,62,220,179,"1600-428"
"1610",0,0,0,0,0,0,0,0,0,0,0,0,0,0,0,0,0,0,0,0,0,0,0,0,0,0,0,0,0,0,0,0,"1700-003"
"1611",6,0,6,6,0,6,0,6,0,0,0,0,54,54,41,13,3,13,31,6,41,31,10,25,7,83,36,47,6,10,41,26,"1800-129"
"1612",9,6,2,8,4,5,0,6,1,0,2,3,17,16,16,0,3,14,9,1,16,11,5,10,4,49,18,31,5,2,20,22,"1700-029"
"1613",7,0,7,4,0,7,0,0,0,5,2,4,159,159,146,13,70,30,16,116,146,90,56,97,57,379,175,204,73,56,195,55,"1750-423"
"1614",6,1,5,3,0,6,1,2,1,2,0,3,52,52,39,13,25,27,22,12,39,26,13,21,12,90,39,51,16,8,52,14,"1050-116"
"1615",30,2,28,29,5,25,21,8,0,1,0,6,176,176,136,40,7,1,46,82,136,105,31,71,31,272,123,149,28,21,174,49,"1170-070"
"1616",8,0,8,8,0,8,0,0,8,0,0,0,123,123,116,7,9,5,89,20,116,56,60,92,41,296,138,158,27,35,163,71,"1070-181"
"1617",18,6,12,17,7,11,7,2,4,0,5,7,155,155,73,82,26,29,29,43,73,56,17,44,15,159,74,85,19,16,88,36,"1170-169"
"1618",1,1,0,1,1,0,0,1,0,0,0,0,1,1,1,0,1,0,0,0,1,1,0,1,0,2,0,2,0,0,2,0,"1070-296"
"1619",10,1,9,10,4,6,3,7,0,0,0,8,45,45,23,22,1,0,5,16,23,20,3,15,5,44,18,26,5,5,16,18,"1950-142"
"1620",0,0,0,0,0,0,0,0,0,0,0,0,0,0,0,0,0,0,0,0,0,0,0,0,0,0,0,0,0,0,0,0,"1900-287"
"1621",34,2,32,34,5,29,2,26,1,5,0,34,358,358,261,97,80,76,128,87,261,162,99,158,85,595,289,306,97,54,347,97,"1900-240"
"1622",13,0,13,13,0,13,0,13,0,0,0,0,81,81,69,12,2,0,12,53,69,56,13,35,10,122,50,72,12,7,66,37,"1900-278"
"1623",12,1,11,11,7,5,7,5,0,0,0,11,88,88,52,36,5,2,16,29,52,43,9,29,10,100,52,48,7,11,46,36,"1070-039"
"1624",17,2,15,17,2,15,2,15,0,0,0,2,92,92,80,12,1,3,21,52,80,62,18,42,12,158,71,87,14,10,82,52,"1900-278"
"1625",34,0,33,29,0,34,17,15,1,0,1,6,262,262,205,57,12,0,77,105,205,148,57,108,45,455,230,225,27,57,267,104,"1900-287"
"1626",11,1,10,11,0,11,11,0,0,0,0,11,60,60,38,22,2,0,15,19,38,32,6,13,3,59,24,35,5,2,35,17,"1900-269"
"1627",12,0,11,8,0,12,12,0,0,0,0,5,120,119,95,24,7,1,32,56,95,69,26,43,17,216,96,120,21,18,136,41,"1000-098"
"1628",41,41,0,41,41,0,4,37,0,0,0,41,41,41,37,4,7,0,0,34,37,14,23,37,23,125,64,61,24,13,64,24,"1500-534"
"1629",34,3,31,33,2,32,13,16,2,3,0,26,252,252,149,103,15,17,61,78,149,103,46,81,34,308,146,162,32,29,172,75,"1900-172"
"1630",19,0,19,18,0,19,19,0,0,0,0,5,124,124,77,47,0,0,12,62,77,58,19,42,18,152,73,79,13,19,95,25,"1900-381"
"1631",38,3,34,28,1,37,7,20,1,9,1,26,297,296,213,83,83,93,134,58,213,157,56,121,54,466,205,261,56,40,226,144,"1050-053"
"1632",7,0,7,7,0,7,0,0,7,0,0,7,80,80,70,10,39,2,1,64,70,31,39,63,36,214,108,106,35,29,127,23,"1900-240"
"1633",4,0,4,4,0,4,4,0,0,0,0,3,29,29,25,4,0,1,0,25,25,19,6,10,5,45,22,23,4,3,26,12,"1170-163"
"1634",13,0,13,11,1,12,8,3,0,2,0,0,128,128,90,38,15,17,38,49,90,69,21,39,18,168,83,85,20,13,102,33,"1050-091"
"1635",12,10,2,12,4,8,0,10,0,2,0,7,22,22,22,0,6,19,18,0,22,11,11,18,12,61,27,34,8,12,29,12,"1070"
"1636",9,2,7,5,2,7,1,0,6,2,0,7,30,30,23,7,3,1,0,22,23,19,4,11,4,38,18,20,2,2,23,11,"1100-478"
"1637",12,1,11,7,1,11,0,7,2,2,1,0,454,454,300,154,205,207,166,100,300,244,56,142,58,559,261,298,54,48,335,122,"1070-060"
"1638",11,0,11,10,0,11,2,5,1,1,2,4,126,126,99,27,37,48,58,32,99,58,41,65,41,256,122,134,40,44,131,41,"1050-098"
"1639",18,0,18,15,0,18,18,0,0,0,0,6,155,155,119,36,4,7,35,69,119,61,58,79,46,327,152,175,51,56,152,68,"1000-134"
"1640",16,5,11,14,3,13,13,0,3,0,0,2,51,51,36,15,4,1,27,5,36,25,11,23,10,77,40,37,9,9,38,21,"1000-197"
"1641",10,2,8,10,1,9,1,5,1,2,1,0,127,127,87,40,58,69,65,14,87,64,23,51,22,185,87,98,23,17,89,56,"1050-078"
"1642",9,9,0,9,4,5,1,8,0,0,0,3,9,9,3,6,1,3,2,0,3,3,0,1,0,5,3,2,0,1,4,0,"1000-067"
"1643",6,5,1,6,6,0,6,0,0,0,0,5,13,13,11,0,3,0,0,10,13,7,6,9,5,32,14,18,8,2,19,3,"1900-330"
"1644",2,1,0,2,1,1,1,1,0,0,0,1,3,2,2,0,1,2,0,1,2,0,2,3,1,36,5,31,4,0,27,5,"1950-052"
"1645",43,6,37,41,11,32,1,41,1,0,0,13,387,387,308,79,40,24,150,130,308,236,72,166,53,616,274,342,57,48,292,219,"1900-381"
"1646",10,0,10,9,0,10,9,0,1,0,0,0,114,114,80,34,19,24,36,37,80,53,27,51,21,184,77,107,20,22,83,59,"1000-044"
"1647",21,0,20,17,1,20,1,0,2,18,0,21,415,414,316,98,226,311,196,91,316,221,95,160,97,671,314,357,97,79,447,48,"1600-785"
"1648",20,0,20,18,0,20,0,0,18,2,0,4,428,428,380,48,328,232,202,156,380,216,164,273,134,945,461,484,112,129,478,226,"1750-170"
"1649",7,0,7,7,0,7,0,7,0,0,0,2,102,102,82,20,29,2,65,13,82,61,21,47,20,166,71,95,21,11,85,49,"1800-100"
"1650",6,0,6,6,0,6,0,0,6,0,0,6,75,75,73,2,53,0,10,62,73,38,35,57,24,182,82,100,16,23,105,38,"1800-328"
"1651",10,0,10,9,0,10,0,0,10,0,0,3,162,162,124,38,106,5,78,30,124,87,37,65,41,253,106,147,40,26,155,32,"1600-638"
"1652",0,0,0,0,0,0,0,0,0,0,0,0,0,0,0,0,0,0,0,0,0,0,0,0,0,0,0,0,0,0,0,0,"1600-600"
"1653",10,9,0,9,8,2,7,2,0,1,0,6,14,11,6,5,2,3,5,0,6,3,3,5,3,47,12,35,10,23,11,3,"1600-515"
"1654",4,0,4,3,0,4,0,0,4,0,0,0,135,135,115,20,107,112,93,15,115,59,56,82,61,291,141,150,58,49,164,20,"1600-416"
"1655",13,0,13,13,0,13,0,0,13,0,0,12,152,152,138,14,87,4,74,61,138,76,62,109,48,349,162,187,42,39,200,68,"1800-328"
"1656",13,0,13,12,0,13,0,0,7,6,0,10,125,125,113,12,99,107,100,10,113,59,54,90,49,298,139,159,35,57,159,47,"1750-184"
"1657",14,0,14,12,0,14,0,0,14,0,0,1,246,246,190,56,180,7,125,47,190,128,62,111,56,413,192,221,53,44,256,60,"1600-638"
"1658",14,1,11,10,3,11,1,10,1,1,1,12,101,99,71,28,5,16,25,39,71,54,17,35,20,176,88,88,15,21,85,55,"1769-001"
"1659",0,0,0,0,0,0,0,0,0,0,0,0,0,0,0,0,0,0,0,0,0,0,0,0,0,0,0,0,0,0,0,0,"1990-233"
"1660",25,23,2,25,13,12,0,0,0,25,0,0,96,96,81,15,54,81,68,7,81,54,27,55,26,189,80,109,17,30,111,31,"1600-645"
"1661",9,0,9,6,0,9,0,0,9,0,0,3,135,135,113,22,97,4,65,34,113,91,22,55,28,211,94,117,33,15,136,27,"1600-600"
"1662",21,21,0,21,21,0,0,20,1,0,0,21,21,21,17,4,7,2,0,16,17,10,7,14,8,44,16,28,7,5,23,9,"1600-647"
"1663",42,42,0,42,23,19,0,42,0,0,0,4,42,42,36,6,12,32,30,2,36,15,21,34,16,109,51,58,22,8,50,29,"1800-364"
"1664",2,2,0,2,2,0,0,2,0,0,0,2,2,2,2,0,2,1,1,0,2,2,0,0,0,2,2,0,0,0,2,0,"1675-122"
"1665",21,0,20,19,1,20,0,21,0,0,0,4,189,188,141,47,22,1,105,22,141,111,30,68,29,270,128,142,35,20,126,89,"1750-143"
"1666",0,0,0,0,0,0,0,0,0,0,0,0,0,0,0,0,0,0,0,0,0,0,0,0,0,0,0,0,0,0,0,0,"1990-027"
"1667",8,2,6,7,0,8,6,2,0,0,0,0,55,55,47,8,4,1,16,26,47,29,18,34,15,111,43,68,20,9,48,34,"1070-292"
"1668",45,27,18,43,27,18,0,45,0,0,0,10,255,255,198,57,22,6,95,87,198,143,55,106,43,398,174,224,41,28,222,107,"1170-284"
"1669",117,98,19,116,107,10,116,1,0,0,0,114,202,202,139,63,20,6,23,108,139,103,36,72,32,281,145,136,31,26,170,54,"1900-439"
"1670",23,0,23,23,0,23,14,9,0,0,0,14,270,270,197,73,18,14,49,137,197,137,60,104,39,426,206,220,44,32,272,78,"1150-021"
"1671",23,23,0,23,20,3,0,16,6,1,0,7,24,24,15,9,3,15,14,0,15,6,9,15,5,45,23,22,6,4,22,13,"1099-035"
"1672",44,43,1,44,42,2,1,23,18,2,0,3,47,47,37,10,7,26,35,0,37,12,25,30,23,106,48,58,22,13,57,14,"1099-035"
"1673",22,6,14,16,4,18,12,8,2,0,0,11,153,151,110,41,21,44,56,44,112,74,38,71,29,288,153,135,44,14,169,61,"1170-225"
"1674",22,0,22,20,4,18,0,17,5,0,0,21,141,141,96,45,2,1,55,33,96,81,15,41,17,167,70,97,13,12,101,41,"1070-271"
"1675",36,1,35,34,6,30,30,5,0,1,0,8,254,254,186,68,16,21,50,118,186,154,32,86,32,349,156,193,26,31,211,81,"1170-230"
"1676",19,2,17,19,6,13,4,14,0,0,1,17,95,95,76,19,3,7,42,30,76,53,23,41,19,152,70,82,22,10,97,23,"1070-283"
"1677",8,0,7,7,0,8,0,5,3,0,0,4,69,68,52,16,8,0,26,21,53,38,15,27,12,108,53,55,12,9,62,25,"1150-007"
"1678",11,1,10,10,1,10,0,7,2,2,0,5,119,119,69,50,10,39,37,28,69,48,21,39,23,145,71,74,23,16,77,29,"1050-116"
"1679",13,0,13,13,0,13,0,13,0,0,0,0,138,138,112,26,14,0,72,30,112,86,26,68,24,225,99,126,9,29,112,75,"1900-311"
"1680",30,8,22,30,11,19,7,22,1,0,0,1,149,149,114,35,2,0,33,74,114,79,35,72,33,238,111,127,25,22,129,62,"1900-311"
"1681",6,0,6,4,0,6,0,0,6,0,0,0,219,219,148,71,114,145,105,24,148,114,34,76,35,291,139,152,35,31,147,78,"1600-131"
"1682",24,0,24,17,0,24,0,24,0,0,0,0,289,289,225,64,62,0,104,99,225,170,55,109,40,439,185,254,37,29,232,141,"1500-384"
"1683",15,0,15,15,0,15,0,0,15,0,0,0,176,176,150,26,135,16,126,19,150,71,79,116,69,419,210,209,62,58,258,41,"1950"
"1684",0,0,0,0,0,0,0,0,0,0,0,0,0,0,0,0,0,0,0,0,0,0,0,0,0,0,0,0,0,0,0,0,"1950"
"1685",12,0,11,10,0,12,1,9,1,1,0,6,84,83,65,18,16,19,34,28,65,32,33,50,32,204,84,120,33,35,95,41,"1000-078"
"1686",20,0,20,16,0,20,9,8,3,0,0,20,188,188,148,40,45,28,85,47,148,101,47,85,46,327,138,189,55,31,174,67,"1000-105"
"1687",25,2,22,24,1,24,0,5,17,0,3,16,175,174,134,39,42,6,44,83,135,83,52,93,47,356,174,182,53,35,171,97,"1600-131"
"1688",16,8,8,15,5,11,2,8,6,0,0,3,71,71,52,19,2,7,16,30,52,47,5,22,8,87,38,49,5,9,56,17,"1600-093"
"1689",14,0,14,14,0,14,3,11,0,0,0,0,125,125,102,23,20,3,60,35,102,76,26,56,23,210,100,110,32,12,117,49,"1000-182"
"1690",10,0,10,8,0,10,3,6,0,0,1,0,61,61,50,11,14,7,34,10,50,37,13,26,12,100,44,56,14,5,58,23,"1000-262"
"1691",5,4,1,5,5,0,0,5,0,0,0,5,8,8,5,3,1,0,1,3,5,2,3,4,3,13,5,8,5,2,6,0,"1950"
"1692",9,0,9,8,1,8,1,8,0,0,0,8,151,151,119,32,40,0,36,73,119,98,21,53,28,213,82,131,20,29,92,72,"1000"
"1693",81,27,54,76,23,58,23,52,2,1,3,45,364,364,264,100,21,16,98,147,264,213,51,120,45,494,232,262,49,35,277,133,"1070-080"
"1694",5,0,5,3,1,4,0,2,3,0,0,5,232,232,183,49,152,94,32,147,183,159,24,79,29,309,152,157,24,21,229,35,"1900-439"
"1695",44,2,42,41,4,40,28,16,0,0,0,28,279,279,226,53,4,0,89,124,226,182,44,111,49,435,195,240,40,42,261,92,"1170"
"1696",13,1,11,11,3,10,11,2,0,0,0,3,74,73,52,21,0,0,33,11,52,38,14,24,12,143,90,53,14,5,100,24,"1150-105"
"1697",41,11,30,36,9,32,20,5,4,10,2,15,187,187,139,48,42,52,71,59,139,101,38,69,38,274,129,145,32,30,164,48,"1070-138"
"1698",40,11,29,39,12,28,16,24,0,0,0,12,198,198,148,50,8,3,54,82,148,114,34,79,35,290,139,151,35,21,162,72,"1070-176"
"1699",25,25,0,25,24,1,5,17,2,1,0,4,25,25,22,3,8,18,20,2,22,14,8,15,7,52,29,23,8,5,26,13,"1070-286"
"1700",16,3,13,15,2,14,12,4,0,0,0,8,78,78,55,23,0,0,13,39,55,44,11,28,8,104,44,60,8,4,67,25,"1170-230"
"1701",0,0,0,0,0,0,0,0,0,0,0,0,0,0,0,0,0,0,0,0,0,0,0,0,0,0,0,0,0,0,0,0,"1069-095"
"1702",23,1,22,18,3,20,15,7,1,0,0,3,151,151,99,52,8,10,45,44,99,75,24,49,17,191,93,98,12,22,113,44,"1150-174"
"1703",25,2,23,17,0,25,16,4,1,4,0,0,148,148,87,61,14,9,37,44,87,59,28,39,21,193,92,101,18,25,123,27,"1050-085"
"1704",9,0,9,6,0,9,0,7,2,0,0,2,84,84,63,21,24,9,33,29,63,30,33,41,27,168,94,74,32,25,89,22,"1070-085"
"1705",17,1,16,14,0,17,8,8,1,0,0,4,114,114,89,25,21,6,57,25,89,60,29,58,25,196,90,106,27,14,104,51,"1070-015"
"1706",15,0,14,14,1,14,0,1,12,2,0,4,375,375,305,70,187,121,148,144,305,156,149,243,138,806,368,438,124,106,429,147,"1950-230"
"1707",25,0,25,16,1,24,2,23,0,0,0,21,224,224,177,47,30,38,105,47,177,116,61,97,57,387,170,217,65,38,199,85,"1000-105"
"1708",9,3,6,9,7,2,7,2,0,0,0,6,32,32,24,8,2,1,2,21,24,16,8,14,9,51,24,27,7,10,23,11,"1950-128"
"1709",18,0,18,17,0,18,0,0,18,0,0,10,158,158,117,41,37,0,16,94,117,69,48,80,36,276,126,150,39,32,141,64,"1600-093"
"1710",12,1,10,11,2,10,0,11,1,0,0,9,123,122,99,23,28,0,12,82,102,63,39,65,36,236,95,141,42,21,120,53,"1000-996"
"1711",15,5,9,14,5,10,0,15,0,0,0,10,93,92,78,14,5,1,19,48,78,64,14,36,11,160,76,84,13,27,84,36,"1500-559"
"1712",28,2,25,26,3,25,11,17,0,0,0,26,168,167,97,70,2,5,30,51,97,77,20,31,10,174,83,91,10,23,86,55,"1600-093"
"1713",9,0,9,9,1,8,0,9,0,0,0,0,171,171,147,24,8,11,62,81,147,109,38,99,37,306,138,168,29,31,135,111,"1950-363"
"1714",11,0,10,11,0,11,0,1,9,1,0,9,196,195,180,15,97,29,66,109,180,113,67,131,47,473,206,267,51,40,197,185,"1950-230"
"1715",23,2,21,11,1,22,7,15,0,1,0,16,182,182,150,32,16,10,56,79,150,112,38,72,33,293,122,171,30,37,151,75,"1000-105"
"1716",2,0,1,2,1,1,0,0,1,1,0,0,13,12,12,0,12,12,11,0,12,5,7,9,5,63,25,38,7,1,20,35,"1500-678"
"1717",3,0,3,3,0,3,0,3,0,0,0,0,29,29,17,12,6,4,9,7,17,9,8,13,8,43,18,25,9,4,26,4,"1069-166"
"1718",37,0,37,30,1,36,0,37,0,0,0,14,506,506,385,121,39,4,171,179,385,319,66,171,67,688,294,394,79,50,351,208,"1500-138"
"1719",8,0,8,4,1,7,0,3,4,1,0,1,158,158,129,29,86,114,108,16,129,78,51,95,41,312,139,173,28,37,146,101,"1900-142"
"1720",28,0,28,21,0,28,0,27,0,0,1,13,136,136,101,35,18,14,49,46,101,79,22,46,14,190,85,105,9,18,114,49,"1600-093"
"1721",32,0,32,24,0,32,0,32,0,0,0,9,385,385,284,101,23,3,142,113,284,205,79,151,73,585,276,309,72,58,312,143,"1000-260"
"1722",37,15,21,33,15,22,21,10,5,1,0,26,137,136,87,49,2,5,25,58,87,76,11,40,12,158,68,90,10,19,88,41,"1600-093"
"1723",0,0,0,0,0,0,0,0,0,0,0,0,0,0,0,0,0,0,0,0,0,0,0,0,0,0,0,0,0,0,0,0,"1900-793"
"1724",32,4,28,31,1,31,1,27,1,2,1,18,212,212,130,82,30,28,57,64,130,109,21,59,20,226,104,122,18,18,117,73,"1600-021"
"1725",16,6,10,14,10,6,14,2,0,0,0,12,102,102,53,49,3,0,0,49,53,36,17,33,11,116,57,59,16,5,64,31,"1950-128"
"1726",0,0,0,0,0,0,0,0,0,0,0,0,0,0,0,0,0,0,0,0,0,0,0,0,0,0,0,0,0,0,0,0,"1500-423"
"1727",9,0,9,9,0,9,0,0,9,0,0,9,107,107,93,14,86,92,85,4,93,56,37,71,34,233,118,115,26,35,119,53,"1900-064"
"1728",27,2,25,21,2,25,7,20,0,0,0,16,264,264,176,88,7,1,63,104,176,143,33,74,29,319,152,167,23,23,189,84,"1500-071"
"1729",10,0,10,4,0,10,0,9,0,0,1,3,145,145,99,46,35,36,46,39,99,65,34,58,26,224,99,125,28,25,116,55,"1069-199"
"1730",5,0,5,5,0,5,0,5,0,0,0,0,190,190,156,34,94,63,119,26,156,81,75,110,69,399,188,211,64,56,220,59,"1950-230"
"1731",15,0,15,10,0,15,0,15,0,0,0,10,163,163,115,48,4,3,56,46,115,79,36,76,33,253,113,140,32,27,130,64,"1000-301"
"1732",23,14,9,23,15,8,8,0,0,15,0,0,76,76,67,9,29,48,43,18,67,34,33,51,34,185,87,98,41,26,106,12,"1500-618"
"1733",8,0,7,7,1,7,0,4,0,4,0,0,77,76,60,16,30,32,41,10,60,40,20,39,20,147,58,89,17,15,71,44,"1000-016"
"1734",24,14,10,23,10,14,18,2,2,2,0,18,53,53,32,21,1,6,10,18,32,26,6,15,5,60,32,28,5,7,28,20,"1600-033"
"1735",42,9,33,40,9,33,6,35,0,1,0,8,403,403,320,83,56,1,127,174,320,256,64,170,70,603,240,363,53,53,312,185,NA
"1736",13,0,13,13,1,12,0,0,0,11,2,0,137,137,88,49,86,88,59,27,88,35,53,74,57,262,136,126,72,30,153,7,"1600-516"
"1737",12,12,0,12,12,0,0,12,0,0,0,1,12,12,11,1,5,10,9,1,11,2,9,9,8,40,17,23,10,6,23,1,"1800-329"
"1738",19,0,19,17,0,19,0,0,0,19,0,18,119,119,96,23,3,2,2,88,96,54,42,67,42,247,118,129,56,39,108,44,"1750-462"
"1739",57,51,6,55,50,7,0,6,51,0,0,16,175,175,151,24,62,40,95,46,151,108,43,92,34,333,148,185,36,31,155,111,"1750-123"
"1740",1,0,1,1,0,1,0,0,0,1,0,0,36,36,30,6,28,30,0,30,30,23,7,19,9,61,35,26,9,4,46,2,"1990-514"
"1741",123,117,6,123,118,5,0,87,33,3,0,22,162,162,127,35,48,27,32,89,127,75,52,89,56,329,146,183,77,35,165,52,"1750-478"
"1742",9,3,6,8,5,4,0,6,1,0,2,9,55,55,50,5,2,8,9,41,50,28,22,36,18,122,64,58,17,18,66,21,"1750-118"
"1743",29,20,9,29,19,10,0,29,0,0,0,18,80,80,67,13,13,16,12,49,67,39,28,49,27,166,74,92,30,18,91,27,"2680"
"1744",50,41,9,50,41,9,4,46,0,0,0,30,114,114,92,22,10,13,27,57,92,59,33,58,31,209,102,107,30,27,101,51,"2680"
"1745",13,3,10,12,3,10,2,3,3,5,0,13,86,86,78,8,4,46,45,29,78,32,46,69,45,233,113,120,56,32,129,16,"1750-462"
"1746",31,28,3,31,30,1,0,30,0,1,0,0,65,65,49,16,29,19,18,31,49,28,21,33,23,123,59,64,34,9,63,17,"1750-478"
"1747",10,0,10,10,0,10,0,5,1,4,0,7,122,122,109,13,15,77,80,27,109,54,55,85,54,302,135,167,70,23,185,24,"1750-478"
"1748",8,0,8,7,0,8,0,0,0,8,0,8,141,141,127,14,16,124,102,19,127,59,68,95,69,344,170,174,91,34,214,5,"1750-478"
"1749",4,0,4,2,0,4,0,4,0,0,0,0,158,158,115,43,24,46,68,32,115,93,22,62,18,218,94,124,15,19,117,67,"1900-383"
"1750",15,5,9,13,2,13,6,5,1,1,2,4,48,47,38,9,6,7,17,15,38,26,12,22,10,99,52,47,23,8,50,18,"1900-036"
"1751",12,0,12,10,0,12,1,9,2,0,0,8,101,101,80,21,19,15,38,33,80,53,27,55,25,190,99,91,29,19,89,53,"1000-120"
"1752",16,0,16,7,0,16,12,2,2,0,0,1,97,97,74,23,10,15,33,31,74,58,16,35,13,151,70,81,17,14,79,41,"1070-067"
"1753",23,21,2,23,20,3,18,0,3,2,0,0,28,28,21,7,10,2,19,2,21,12,9,15,6,51,23,28,9,2,28,12,"1000-189"
"1754",10,0,10,10,0,10,0,9,1,0,0,5,174,174,135,39,37,1,41,87,135,89,46,100,35,323,145,178,36,28,138,121,"1950-244"
"1755",41,2,39,37,2,39,1,37,3,0,0,7,345,345,275,70,10,10,137,119,275,231,44,124,41,476,200,276,43,30,262,141,"1500-175"
"1756",15,0,15,13,0,15,0,15,0,0,0,15,254,254,193,61,56,0,107,70,193,159,34,97,35,352,161,191,30,26,150,146,"1500-547"
"1757",11,4,7,7,4,7,11,0,0,0,0,8,30,30,23,7,2,2,7,15,23,18,5,12,4,45,20,25,3,4,27,11,"1100-616"
"1758",2,0,2,0,0,2,2,0,0,0,0,1,7,7,4,3,1,0,0,4,4,2,2,2,1,12,10,2,1,0,9,2,"1100-062"
"1759",8,0,8,4,0,8,7,0,0,0,1,2,50,50,17,33,1,5,7,10,17,14,3,8,1,30,18,12,1,2,20,7,"1200-247"
"1760",22,4,18,16,0,22,22,0,0,0,0,11,112,112,53,59,2,0,8,43,53,42,11,16,9,89,40,49,8,8,59,14,"1200-383"
"1761",28,3,25,25,2,26,11,13,2,2,0,14,232,232,182,50,21,23,75,90,182,121,61,108,50,413,201,212,56,43,226,88,"1200-747"
"1762",7,1,6,7,0,7,4,3,0,0,0,7,35,35,11,24,0,0,2,9,11,9,2,5,1,18,6,12,0,2,9,7,"1200-047"
"1763",9,0,9,8,0,9,0,0,0,0,9,0,209,209,166,43,163,166,110,47,166,83,83,118,83,433,213,220,117,36,262,18,"1750-204"
"1764",15,0,15,13,0,15,0,15,0,0,0,0,267,267,226,41,34,8,152,54,226,154,72,144,68,490,235,255,54,51,251,134,"1800-281"
"1765",7,0,7,5,0,7,0,0,2,5,0,0,137,137,110,27,92,109,84,19,110,76,34,77,37,249,121,128,32,27,150,40,"1990-009"
"1766",1,0,0,1,1,0,1,0,0,0,0,0,3,0,0,0,0,0,0,0,0,0,0,0,0,291,85,206,1,0,5,285,"1750-011"
"1767",6,0,6,6,0,6,0,5,1,0,0,0,227,227,189,38,71,172,147,22,189,134,55,125,52,416,189,227,55,33,203,125,"1750-161"
"1768",8,0,7,8,1,7,0,0,0,8,0,0,79,78,72,6,71,72,59,10,72,24,48,63,45,249,110,139,46,35,121,47,"1990-099"
"1769",25,14,10,23,18,7,7,16,2,0,0,15,76,75,58,17,13,5,8,48,58,29,29,39,26,179,80,99,32,21,79,47,"1600-516"
"1770",6,0,6,6,0,6,0,0,6,0,0,0,44,44,42,2,39,42,36,5,42,20,22,30,20,128,62,66,19,33,50,26,"1990-370"
"1771",10,0,10,10,0,10,0,10,0,0,0,0,100,100,92,8,6,5,66,19,92,56,36,62,27,216,103,113,20,29,107,60,"1800-281"
"1772",9,0,9,8,0,9,0,9,0,0,0,9,130,130,98,32,5,3,51,37,98,82,16,44,14,180,67,113,13,18,98,51,"1750-161"
"1773",5,0,5,4,0,5,0,0,0,5,0,0,120,120,94,26,90,94,74,17,94,45,49,67,51,256,132,124,61,32,155,8,"1990-099"
"1774",8,0,8,8,0,8,0,0,8,0,0,8,259,259,244,15,196,31,11,219,244,112,132,214,133,720,343,377,139,97,375,109,"1700-474"
"1775",7,0,7,5,0,7,0,0,3,4,0,0,136,136,114,22,107,114,89,20,114,46,68,92,66,338,160,178,81,47,173,37,"1900-238"
"1776",2,0,2,1,0,2,0,0,2,0,0,0,111,111,96,15,92,95,77,13,96,57,39,70,28,246,119,127,29,32,127,58,"1750-011"
"1777",6,0,6,6,0,6,0,0,5,1,0,0,65,65,56,9,45,56,50,5,56,27,29,50,27,156,77,79,28,21,78,29,"1990-118"
"1778",19,0,19,13,0,19,0,19,0,0,0,0,182,182,158,24,6,4,114,35,158,103,55,111,39,363,167,196,31,34,172,126,"1800-412"
"1779",14,0,14,12,0,14,0,14,0,0,0,1,228,228,185,43,98,5,144,30,185,139,46,110,44,385,183,202,33,45,173,134,"1800-281"
"1780",11,0,11,9,0,11,0,0,0,11,0,0,155,155,142,13,136,142,112,24,142,64,78,109,84,394,192,202,94,59,215,26,"1990-390"
"1781",1,0,0,1,1,0,0,0,0,0,1,0,1,0,0,0,0,0,0,0,0,0,0,0,0,39,33,6,0,1,37,1,"1990"
"1782",15,0,15,14,0,15,0,0,0,15,0,0,355,355,303,52,292,302,238,55,303,138,165,211,166,815,384,431,231,80,477,27,"1700-474"
"1783",12,1,10,10,1,11,0,10,1,1,0,4,88,87,53,34,5,5,27,19,53,41,12,20,9,144,50,94,10,3,61,70,"1600-170"
"1784",14,0,14,13,0,14,0,9,1,4,0,6,136,136,107,29,49,1,23,75,107,75,32,65,27,224,96,128,16,29,121,58,"1600-198"
"1785",20,1,19,19,20,0,0,20,0,0,0,0,76,76,64,12,6,1,28,28,64,38,26,51,17,160,81,79,10,15,85,50,"1950-230"
"1786",21,0,21,17,0,21,21,0,0,0,0,11,112,112,66,45,5,0,17,46,67,60,7,26,8,112,49,63,9,6,76,21,"1200-865"
"1787",21,6,15,10,4,17,10,11,0,0,0,6,92,92,51,41,8,7,27,23,51,33,18,20,9,101,54,47,5,9,57,30,"1200-429"
"1788",27,14,13,26,22,5,0,26,0,1,0,16,73,73,52,21,7,1,20,29,52,39,13,31,10,103,50,53,8,9,54,32,"1300-611"
"1789",38,2,35,28,2,36,22,9,0,6,1,1,410,409,311,97,93,88,185,104,312,176,136,208,131,795,363,432,162,90,424,119,"1350-179"
"1790",5,2,3,4,1,4,0,1,3,0,1,0,16,16,5,11,2,5,5,0,5,4,1,5,1,12,6,6,1,1,3,7,"1200-429"
"1791",20,1,19,13,1,19,15,5,0,0,0,7,100,100,64,36,5,0,9,55,64,50,14,30,8,120,51,69,5,13,77,25,NA
"1792",14,1,13,8,4,10,13,0,0,0,1,6,71,71,37,34,6,2,6,28,37,26,11,20,9,73,32,41,11,3,48,11,"1200-067"
"1793",4,0,4,1,0,4,0,0,2,0,2,2,53,53,8,45,0,0,3,5,8,7,1,3,1,13,9,4,0,2,10,1,"1200-014"
"1794",8,1,6,3,0,8,7,0,1,0,0,2,34,33,14,19,0,1,6,8,15,12,3,8,4,30,14,16,5,3,16,6,"1100-521"
"1795",35,15,20,34,25,10,0,33,2,0,0,19,150,150,111,39,13,26,23,82,111,73,38,74,42,257,112,145,47,30,115,65,"2680"
"1796",27,7,20,25,17,10,1,20,6,0,0,12,188,188,133,55,19,20,34,93,133,92,41,84,48,290,129,161,47,37,150,56,"1750-478"
"1797",16,9,7,16,11,5,0,16,0,0,0,13,84,84,72,12,7,6,3,66,72,43,29,46,29,179,82,97,37,27,84,31,"2680"
"1798",12,4,8,10,4,8,3,3,5,1,0,4,61,61,55,6,1,17,25,27,55,29,26,43,22,149,73,76,23,18,87,21,"2680"
"1799",2,0,2,1,0,2,1,1,0,0,0,0,25,25,7,18,1,1,2,3,7,5,2,2,2,12,7,5,1,1,9,1,"1250-142"
"1800",13,0,12,12,1,12,0,8,5,0,0,6,266,265,188,76,63,126,127,51,189,147,42,115,33,422,159,263,33,23,180,186,"1900-040"
"1801",36,1,35,29,0,36,6,21,2,2,5,15,489,489,345,144,195,212,199,121,345,219,126,220,129,813,374,439,137,113,401,162,"1070-100"
"1802",10,0,10,10,0,10,0,0,0,10,0,0,82,82,77,5,72,4,2,73,77,39,38,67,37,218,102,116,26,39,124,29,"1070"
"1803",3,0,3,3,0,3,0,0,3,0,0,0,66,66,58,8,2,2,48,5,58,39,19,46,13,131,69,62,5,11,74,41,"1070"
"1804",20,0,20,13,0,20,19,1,0,0,0,1,175,175,144,31,9,0,81,49,144,90,54,80,53,331,145,186,63,42,173,53,"1250-272"
"1805",10,0,10,9,0,10,0,0,0,10,0,10,99,99,86,13,62,3,1,83,86,45,41,75,34,232,112,120,37,25,124,46,"1900-028"
"1806",31,0,31,21,0,31,29,0,1,0,1,10,237,237,184,53,9,11,70,103,184,97,87,114,53,498,279,219,69,37,321,71,"1170-375"
"1807",30,2,26,19,2,28,7,23,0,0,0,2,235,233,170,63,27,22,102,54,171,80,91,118,76,497,239,258,77,90,242,88,"1250-068"
"1808",61,34,27,57,38,23,7,49,3,2,0,39,256,256,180,76,17,21,70,96,180,125,55,114,46,384,171,213,49,24,203,108,"1300-477"
"1809",9,7,2,9,3,6,9,0,0,0,0,0,15,15,13,2,2,0,10,3,13,8,5,7,6,33,15,18,8,3,18,4,"1000-300"
"1810",0,0,0,0,0,0,0,0,0,0,0,0,0,0,0,0,0,0,0,0,0,0,0,0,0,0,0,0,0,0,0,0,"1099-023"
"1811",29,0,29,26,0,29,27,1,0,0,1,13,220,220,163,57,14,7,72,84,163,128,35,74,30,325,171,154,26,32,212,55,"1900-999"
"1812",22,9,13,22,19,3,0,6,9,7,0,2,68,68,58,10,6,2,37,18,58,50,8,28,6,98,40,58,5,4,50,39,"1900-999"
"1813",21,9,12,21,12,9,2,5,8,6,0,1,101,101,82,19,7,7,32,41,82,55,27,50,22,186,93,93,19,21,104,42,"1900-182"
"1814",13,2,11,11,0,13,5,6,0,2,0,8,114,114,89,25,37,27,43,35,89,69,20,49,21,173,79,94,17,17,93,46,"1050-220"
"1815",25,9,15,24,6,19,23,2,0,0,0,12,113,112,77,35,2,11,24,45,77,55,22,41,23,208,95,113,24,17,91,76,"1950-052"
"1816",19,0,19,16,0,19,9,9,0,1,0,1,153,153,120,33,2,0,59,50,120,84,36,60,31,264,124,140,34,26,151,53,"1900-183"
"1817",26,1,25,22,1,25,2,23,0,1,0,5,234,234,180,54,12,8,88,82,180,122,58,106,54,396,179,217,62,33,230,71,"1000-193"
"1818",1,1,0,1,1,0,1,0,0,0,0,1,1,1,1,0,1,0,0,1,1,1,0,1,0,2,1,1,0,0,2,0,"1900-381"
"1819",6,6,0,6,3,3,5,0,1,0,0,0,7,7,4,3,1,0,2,2,4,3,1,1,1,7,2,5,1,1,4,1,"1000-300"
"1820",82,81,1,82,81,1,7,75,0,0,0,80,85,85,66,19,9,2,42,22,66,32,34,55,28,184,84,100,13,30,90,51,"1500-554"
"1821",10,0,10,9,0,10,10,0,0,0,0,6,44,44,33,11,2,0,26,4,33,21,12,20,15,79,39,40,15,14,33,17,"1000-300"
"1822",11,0,11,10,0,11,0,10,0,1,0,2,119,119,87,32,26,12,48,34,87,55,32,60,30,214,99,115,35,25,104,50,"1700"
"1823",64,0,61,54,0,64,9,55,0,0,0,28,676,673,490,183,120,58,284,163,491,294,197,316,178,1236,541,695,195,150,572,319,"1000-226"
"1824",9,8,1,9,7,2,7,0,2,0,0,0,19,19,16,3,10,15,14,1,16,5,11,14,9,62,25,37,12,14,30,6,"1500-554"
"1825",14,0,14,7,0,14,0,12,0,2,0,6,124,124,90,34,27,35,38,45,90,59,31,57,28,209,94,115,42,14,114,39,"1700-037"
"1826",13,0,12,13,0,13,0,0,1,12,0,0,287,286,235,51,193,234,183,35,235,143,92,161,93,568,270,298,81,76,327,84,"1600-149"
"1827",5,0,5,5,0,5,0,0,2,3,0,0,177,177,151,26,118,150,123,19,151,82,69,116,64,387,187,200,53,59,216,59,"1600-223"
"1828",11,0,11,11,0,11,0,11,0,0,0,0,127,127,87,40,1,2,41,36,87,70,17,44,20,171,77,94,20,11,90,50,"1600-145"
"1829",5,0,5,5,0,5,0,4,1,0,0,0,164,164,136,28,130,133,110,19,136,81,55,99,45,314,153,161,28,35,174,77,"1600-145"
"1830",5,1,4,4,1,4,0,5,0,0,0,4,24,24,19,5,2,0,15,2,19,17,2,9,1,34,18,16,2,0,19,13,"1700-182"
"1831",10,4,5,10,5,5,0,10,0,0,0,2,21,20,14,6,4,8,12,2,14,6,8,13,8,53,19,34,12,4,23,14,"1700-204"
"1832",2,0,2,1,0,2,0,2,0,0,0,2,127,127,116,11,75,1,47,64,116,77,39,91,26,271,125,146,30,19,104,118,"1950-001"
"1833",11,0,11,9,0,11,0,8,2,1,0,6,301,301,278,23,129,3,93,177,278,186,92,203,64,641,299,342,60,63,264,254,"1950-244"
"1834",59,47,10,58,26,33,0,49,0,2,8,33,208,206,158,48,20,35,63,83,158,81,77,114,65,435,190,245,81,46,202,106,"1700-198"
"1835",0,0,0,0,0,0,0,0,0,0,0,0,0,0,0,0,0,0,0,0,0,0,0,0,0,0,0,0,0,0,0,0,"1749-081"
"1836",14,0,14,14,0,14,0,14,0,0,0,6,316,316,253,63,97,5,146,85,253,186,67,148,52,510,234,276,54,23,267,166,"1500-231"
"1837",4,0,4,4,0,4,0,1,2,1,0,0,78,78,63,15,21,51,54,5,63,42,21,40,16,128,61,67,12,10,67,39,"1800-048"
"1838",14,14,0,14,13,1,0,12,1,0,1,0,14,14,12,2,3,12,12,0,12,6,6,9,6,32,17,15,9,2,18,3,"1800-192"
"1839",6,0,6,4,0,6,0,3,3,0,0,5,257,257,236,21,110,7,36,196,236,143,93,168,88,562,267,295,73,75,305,109,"1800-292"
"1840",6,0,6,5,0,6,0,0,0,6,0,0,177,177,146,31,132,145,122,19,146,76,70,103,71,376,168,208,75,46,220,35,"1750-316"
"1841",98,98,0,98,98,0,0,79,19,0,0,89,98,98,47,51,2,2,1,45,47,29,18,35,14,118,58,60,19,8,56,35,"1675-632"
"1842",0,0,0,0,0,0,0,0,0,0,0,0,0,0,0,0,0,0,0,0,0,0,0,0,0,0,0,0,0,0,0,0,"1740-441"
"1843",26,26,0,26,20,6,0,22,1,1,2,2,26,26,21,5,6,18,17,2,21,8,13,17,9,63,32,31,5,12,33,13,"1800-111"
"1844",3,0,3,3,0,3,0,3,0,0,0,3,92,92,82,10,10,0,7,71,82,50,32,54,20,190,97,93,21,12,97,60,"1800-292"
"1845",56,22,32,52,26,30,14,20,22,0,0,31,329,327,227,100,25,45,115,82,227,178,49,120,41,484,219,265,35,32,290,127,"1199-010"
"1846",10,3,7,8,1,9,4,4,1,0,1,3,51,51,38,13,15,5,19,14,38,36,2,17,1,64,29,35,1,2,46,15,"1050-225"
"1847",79,76,3,79,76,3,0,79,0,0,0,69,100,100,63,37,3,1,6,55,63,51,12,30,10,131,63,68,20,11,77,23,"1070-181"
"1848",5,3,1,5,4,1,4,1,0,0,0,5,9,7,4,3,0,0,0,4,4,2,2,2,1,157,135,22,1,8,131,17,"1900-048"
"1849",10,0,10,10,0,10,0,0,7,3,0,3,92,92,88,4,17,3,24,63,88,42,46,82,43,264,122,142,36,47,136,45,"1070-181"
"1850",24,3,21,23,4,20,3,20,1,0,0,17,169,169,130,39,4,3,92,29,130,87,43,75,28,275,125,150,31,16,143,85,"1900-194"
"1851",23,1,22,20,1,22,7,15,1,0,0,15,243,243,180,63,13,6,38,127,180,135,45,80,34,371,164,207,34,37,221,79,"1170-278"
"1852",18,3,15,16,6,12,6,10,2,0,0,12,98,98,66,32,8,2,26,34,66,53,13,31,10,126,46,80,10,13,64,39,"1649-028"
"1853",5,0,5,5,0,5,0,5,0,0,0,3,30,30,27,3,2,0,25,1,27,16,11,18,11,64,25,39,5,10,32,17,"1800-100"
"1854",17,17,0,17,7,10,0,0,17,0,0,0,17,17,13,4,9,13,11,0,13,9,4,9,4,32,13,19,4,5,12,11,"1600-645"
"1855",2,0,2,1,0,2,0,2,0,0,0,2,45,45,39,6,1,1,30,8,39,29,10,23,5,74,25,49,6,0,33,35,"1800-328"
"1856",12,1,11,10,1,11,10,2,0,0,0,6,58,58,34,24,5,4,13,17,34,27,7,17,8,65,27,38,10,3,41,11,"1200"
"1857",14,7,7,12,3,11,12,0,1,0,1,7,41,41,25,16,7,3,7,17,25,19,6,15,6,53,29,24,1,7,40,5,"1200"
"1858",35,16,19,33,17,18,14,12,9,0,0,14,125,125,75,50,3,5,24,47,75,55,20,39,15,154,69,85,17,13,90,34,"1350-259"
"1859",17,7,10,12,6,11,17,0,0,0,0,9,58,58,34,24,1,2,13,17,34,32,2,12,2,54,23,31,4,1,37,12,"1100-192"
"1860",4,0,4,4,0,4,4,0,0,0,0,3,26,26,9,17,1,0,4,5,9,3,6,4,3,28,19,9,7,1,19,1,"1100-524"
"1861",19,0,19,16,3,16,14,5,0,0,0,4,84,84,56,28,3,0,8,47,56,47,9,20,8,105,51,54,8,13,64,20,"1200-267"
"1862",2,0,2,1,0,2,0,1,1,0,0,2,8,8,4,4,1,0,0,4,4,3,1,3,2,8,5,3,3,0,3,2,"1100-350"
"1863",17,13,2,17,17,0,17,0,0,0,0,9,23,21,7,14,1,0,2,5,7,6,1,4,2,37,21,16,1,26,7,3,"1349-021"
"1864",3,0,3,3,0,3,0,0,3,0,0,0,52,52,42,10,16,1,1,38,42,13,29,42,25,151,74,77,20,26,81,24,"1300-134"
"1865",28,9,19,25,18,10,22,6,0,0,0,9,133,133,100,32,9,12,37,55,101,80,21,53,18,191,90,101,13,14,112,52,"1300-611"
"1866",15,4,11,12,0,15,10,3,0,0,2,7,62,62,42,20,12,16,22,16,42,21,21,34,19,119,61,58,26,13,53,27,"1200-701"
"1867",5,0,5,2,0,5,3,0,1,0,1,2,31,31,15,16,6,0,11,4,15,13,2,5,2,24,11,13,2,1,17,4,"1100-585"
"1868",3,1,2,2,0,3,3,0,0,0,0,3,15,15,12,3,1,0,6,6,12,9,3,7,4,25,12,13,3,5,12,5,"1100-524"
"1869",25,8,17,21,6,19,25,0,0,0,0,15,102,102,61,41,5,4,27,33,61,49,12,28,7,112,61,51,5,10,71,26,"1200-865"
"1870",10,2,8,6,1,9,2,8,0,0,0,3,37,37,23,14,1,0,8,12,23,20,3,10,3,38,15,23,3,4,24,7,"1200-263"
"1871",15,2,13,5,4,11,1,13,0,0,1,8,44,44,27,17,1,1,12,13,27,21,6,12,4,48,26,22,3,3,35,7,"1200-073"
"1872",2,0,1,0,0,2,2,0,0,0,0,1,5,5,5,0,0,0,2,2,5,4,1,1,1,7,3,4,1,0,5,1,"1100-053"
"1873",2,1,1,2,1,1,0,0,2,0,0,0,23,23,11,12,8,10,8,2,11,9,2,5,2,19,10,9,1,2,11,5,"1249-058"
"1874",5,1,3,3,0,5,3,1,1,0,0,3,25,24,14,10,0,0,6,7,14,12,2,4,2,39,13,26,2,1,12,24,"1249-203"
"1875",48,4,43,23,4,44,17,27,3,1,0,12,206,205,116,89,11,7,49,53,116,77,39,64,26,279,147,132,51,21,155,52,"1200-070"
"1876",12,11,0,12,4,8,0,4,8,0,0,3,12,11,6,5,2,6,5,1,6,2,4,6,4,44,11,33,6,4,7,27,"1400-021"
"1877",9,0,9,6,1,8,9,0,0,0,0,2,35,35,25,10,0,0,7,16,25,18,7,14,5,48,24,24,5,5,27,11,"1200-263"
"1878",51,22,29,48,33,18,36,11,3,1,0,31,165,165,128,37,23,2,33,86,128,88,40,80,35,291,144,147,33,35,154,69,"1300-611"
"1879",0,0,0,0,0,0,0,0,0,0,0,0,0,0,0,0,0,0,0,0,0,0,0,0,0,0,0,0,0,0,0,0,"1600-616"
"1880",1,1,0,1,1,0,0,1,0,0,0,1,1,1,0,1,0,0,0,0,0,0,0,0,0,0,0,0,0,0,0,0,"1500-225"
"1881",44,28,16,44,28,16,31,0,13,0,0,44,242,242,213,29,35,4,156,45,213,148,65,146,44,462,218,244,31,33,241,157,"1900-040"
"1882",4,0,4,4,0,4,1,0,3,0,0,0,69,69,62,7,2,1,56,4,62,40,22,48,15,146,65,81,11,12,85,38,"1070"
"1883",38,2,36,36,1,37,16,11,8,3,0,22,306,306,243,63,88,93,146,77,243,168,75,141,63,536,274,262,56,55,303,122,"1170-028"
"1884",11,0,11,6,0,11,7,4,0,0,0,1,133,133,74,59,12,5,21,43,74,63,11,38,9,133,64,69,9,12,67,45,"1250-068"
"1885",5,3,2,5,3,2,4,1,0,0,0,4,11,11,7,4,1,2,0,7,7,3,4,6,4,17,7,10,4,2,7,4,"1300-125"
"1886",1,0,1,1,0,1,1,0,0,0,0,0,6,6,3,3,0,1,1,1,3,2,1,2,1,6,2,4,0,1,3,2,"1250-149"
"1887",6,4,2,6,4,2,5,0,0,0,1,1,122,122,7,115,1,1,0,7,7,7,0,1,0,8,4,4,0,1,6,1,"1900-046"
"1888",72,43,29,72,53,19,64,6,1,0,1,35,222,222,183,38,39,7,111,55,184,125,59,102,46,421,194,227,41,44,251,85,"1170-340"
"1889",21,0,21,19,0,21,0,2,13,6,0,8,134,134,92,42,3,0,53,28,92,64,28,56,27,201,91,110,28,17,110,46,"1900-015"
"1890",29,2,27,28,4,25,14,14,1,0,0,10,199,199,139,60,10,1,37,88,139,115,24,65,21,255,122,133,19,27,145,64,"1900-221"
"1891",25,1,24,23,1,24,1,16,7,1,0,9,140,140,103,37,1,8,40,60,103,84,19,45,13,186,81,105,13,12,110,51,"1900-172"
"1892",18,0,18,16,0,18,15,1,0,0,2,4,122,122,67,55,0,0,40,20,67,53,14,34,19,128,48,80,17,13,82,16,"1000-226"
"1893",18,0,18,12,0,18,0,15,1,2,0,6,172,172,114,58,16,7,35,67,114,83,31,49,24,224,108,116,26,19,125,54,"1900-183"
"1894",25,1,24,25,0,25,6,19,0,0,0,8,197,197,115,82,4,2,13,97,115,87,28,65,19,228,105,123,15,16,114,83,"1900-032"
"1895",10,10,0,10,10,0,7,0,3,0,0,4,11,11,11,0,3,8,8,2,11,10,1,7,2,20,11,9,1,1,6,12,"1070-023"
"1896",11,5,6,10,2,9,3,8,0,0,0,7,39,39,30,9,2,2,6,23,30,23,7,16,8,57,24,33,8,3,31,15,"1050-072"
"1897",7,7,0,7,7,0,6,0,0,1,0,0,7,7,7,0,0,0,6,0,7,4,3,4,2,19,11,8,2,2,10,5,"1000-283"
"1898",14,1,13,12,1,13,0,4,9,0,1,7,123,123,96,27,41,43,55,32,96,66,30,59,29,221,115,106,32,22,115,52,"1048-017"
"1899",16,0,16,16,0,16,0,0,9,7,0,16,192,192,182,10,157,2,28,146,182,90,92,167,78,523,256,267,64,71,309,79,"1950-347"
"1900",10,0,10,9,0,10,10,0,0,0,0,1,45,45,36,9,2,0,24,7,36,20,16,24,16,91,33,58,19,12,41,19,"1000-189"
"1901",14,0,14,10,0,14,0,14,0,0,0,14,85,85,78,7,4,1,25,46,78,48,30,53,31,179,84,95,22,24,94,39,"1700-237"
"1902",14,0,14,14,0,14,0,3,11,0,0,0,82,82,71,11,1,6,62,7,71,41,30,56,19,172,84,88,19,11,94,48,"1950-053"
"1903",3,0,3,3,0,3,0,3,0,0,0,1,80,80,65,15,41,0,41,22,65,39,26,47,17,153,74,79,17,13,62,61,"1950-002"
"1904",11,11,0,11,1,10,0,5,3,3,0,2,11,11,10,1,2,8,8,1,10,5,5,8,4,26,14,12,4,3,15,4,"1400-406"
"1905",18,18,0,18,3,15,0,12,3,3,0,2,18,18,18,0,2,10,16,1,18,9,9,12,7,45,22,23,2,11,23,9,"1400-406"
"1906",46,10,35,36,5,41,26,17,2,0,1,22,245,244,150,94,14,24,59,76,150,109,41,83,37,309,155,154,37,28,190,54,"1250-096"
"1907",16,4,10,16,1,15,13,3,0,0,0,5,56,54,32,22,3,4,11,17,33,25,8,11,7,65,31,34,6,7,37,15,"1200-257"
"1908",39,4,34,35,8,31,12,16,9,1,1,8,475,474,329,145,180,237,202,104,330,247,83,190,87,680,321,359,83,77,373,147,"1070-073"
"1909",2,2,0,2,2,0,0,2,0,0,0,0,2,2,1,1,1,1,0,1,1,0,1,2,1,6,2,4,2,0,4,0,"1500-624"
"1910",23,23,0,23,15,8,0,23,0,0,0,0,23,23,22,1,3,14,18,1,22,12,10,16,7,55,27,28,5,9,29,12,"1900-311"
"1911",18,18,0,18,11,7,0,18,0,0,0,2,18,18,16,2,1,12,15,0,16,9,7,9,6,36,21,15,6,4,16,10,"1900-278"
"1912",31,0,31,27,1,30,28,2,1,0,0,8,220,220,160,60,2,8,68,73,160,105,55,87,38,391,203,188,28,37,268,58,"1900-998"
"1913",24,0,23,18,0,24,15,9,0,0,0,22,152,151,102,49,3,0,41,55,103,66,37,55,31,252,121,131,33,22,145,52,"1170-141"
"1914",6,0,6,3,0,6,0,0,6,0,0,0,175,175,122,53,114,120,74,35,122,107,15,69,16,219,114,105,12,19,117,71,"1069-069"
"1915",16,16,0,16,16,0,9,4,1,2,0,2,17,17,16,1,4,13,14,1,16,8,8,13,8,44,23,21,3,11,21,9,"1070-181"
"1916",14,0,14,9,0,14,9,1,3,1,0,1,128,128,91,37,13,21,34,47,91,70,21,42,14,178,89,89,11,16,112,39,"1050-136"
"1917",27,27,0,27,27,0,0,27,0,0,0,13,27,27,24,3,6,14,22,1,24,17,7,17,7,53,24,29,3,8,28,14,"1900-107"
"1918",27,0,26,22,0,27,19,6,2,0,0,16,222,221,155,65,19,12,66,80,156,94,62,88,52,415,214,201,49,48,225,93,"1150-023"
"1919",1,0,0,0,0,1,1,0,0,0,0,1,8,0,0,0,0,0,0,0,0,0,0,0,0,383,383,0,0,23,352,8,"1099-011"
"1920",24,0,24,21,0,24,1,21,1,1,0,5,156,156,120,36,8,8,37,77,120,84,36,68,32,252,119,133,28,25,142,57,"1900-998"
"1921",4,4,0,4,4,0,1,3,0,0,0,4,4,4,4,0,1,0,0,4,4,4,0,4,0,8,4,4,0,0,1,7,"1500-663"
"1922",34,1,32,28,0,34,6,28,0,0,0,24,244,244,145,99,21,19,57,75,145,97,48,79,30,337,158,179,39,32,192,74,"1150-015"
"1923",39,7,32,35,8,31,15,24,0,0,0,14,191,191,145,46,4,0,37,102,145,87,58,84,39,338,153,185,29,54,186,69,"1170-179"
"1924",1,0,0,1,0,1,0,1,0,0,0,1,6,5,5,0,0,0,0,3,6,4,2,1,0,11,7,4,0,0,9,2,"1050-234"
"1925",29,1,27,20,0,29,7,22,0,0,0,6,309,308,240,68,25,10,97,122,240,174,66,113,48,525,239,286,56,44,288,137,"1000-032"
"1926",25,2,23,21,4,21,16,7,2,0,0,15,166,166,124,42,5,17,58,56,124,89,35,65,33,264,117,147,26,23,167,48,"1000-168"
"1927",51,9,42,44,9,42,29,17,3,2,0,12,352,352,233,119,27,50,104,117,233,190,43,106,38,420,181,239,38,24,239,119,"1000-060"
"1928",26,6,20,24,7,19,3,19,2,0,2,12,145,145,104,41,3,9,38,60,104,65,39,61,28,253,126,127,35,21,153,44,"1900-462"
"1929",9,0,9,8,0,9,0,8,1,0,0,5,67,67,53,14,2,2,25,27,53,35,18,31,12,127,63,64,14,11,77,25,"1000-008"
"1930",13,0,13,11,0,13,0,0,13,0,0,6,202,202,146,56,117,9,86,53,146,74,72,121,62,398,188,210,54,43,243,58,"1950-354"
"1931",11,0,11,10,0,11,0,10,0,1,0,2,119,119,95,24,28,11,52,38,95,74,21,45,16,202,94,108,14,13,83,92,"1500-285"
"1932",18,0,18,17,0,18,0,0,10,8,0,18,319,319,289,30,163,124,135,134,289,134,155,237,131,792,376,416,125,98,448,121,"1950-338"
"1933",14,1,13,14,1,13,2,10,2,0,0,2,124,124,90,34,24,25,46,35,90,67,23,48,19,174,70,104,19,11,90,54,"1500-158"
"1934",29,0,28,26,1,28,0,28,1,0,0,27,416,415,305,110,109,130,163,122,306,248,58,153,55,573,256,317,50,45,296,182,"1500-588"
"1935",10,0,10,6,0,10,0,10,0,0,0,6,191,191,161,30,4,18,123,23,161,127,34,92,29,311,130,181,23,18,187,83,"1800-131"
"1936",4,0,4,4,0,4,0,3,1,0,0,2,72,72,64,8,4,1,40,17,64,39,25,40,19,151,71,80,21,14,87,29,"1800-328"
"1937",1,0,1,0,0,1,0,0,0,1,0,0,35,35,17,18,16,17,7,10,17,10,7,11,7,46,21,25,3,12,28,3,"1990-078"
"1938",0,0,0,0,0,0,0,0,0,0,0,0,0,0,0,0,0,0,0,0,0,0,0,0,0,0,0,0,0,0,0,0,"1990"
"1939",7,0,7,5,0,7,0,7,0,0,0,6,126,126,106,20,5,1,73,21,106,73,33,54,23,223,101,122,29,16,117,61,"1800-328"
"1940",31,15,16,30,17,14,2,26,3,0,0,21,111,111,101,10,12,29,29,64,101,71,30,67,19,213,106,107,18,18,118,59,"2680"
"1941",11,0,11,8,0,11,0,1,0,10,0,1,197,197,161,36,132,160,132,20,161,82,79,112,74,406,206,200,75,50,252,29,"1800-328"
"1942",0,0,0,0,0,0,0,0,0,0,0,0,0,0,0,0,0,0,0,0,0,0,0,0,0,0,0,0,0,0,0,0,"1600-600"
"1943",22,1,20,19,1,21,0,21,1,0,0,4,321,320,263,57,93,66,152,92,263,184,79,151,63,580,251,329,64,72,267,177,"1750-142"
"1944",18,0,18,18,0,18,0,17,1,0,0,3,218,218,166,52,14,11,99,62,166,130,36,114,33,347,149,198,21,30,124,172,"1800-105"
"1945",22,14,8,22,14,8,0,10,8,4,0,0,127,127,109,18,43,104,92,10,109,69,40,84,38,264,135,129,24,38,147,55,"1600-548"
"1946",4,0,4,4,0,4,0,2,1,1,0,4,104,104,84,20,4,65,63,11,84,64,20,45,13,171,83,88,17,15,83,56,"1750-149"
"1947",0,0,0,0,0,0,0,0,0,0,0,0,0,0,0,0,0,0,0,0,0,0,0,0,0,0,0,0,0,0,0,0,"1990-233"
"1948",23,0,23,20,1,22,1,22,0,0,0,8,303,303,263,40,91,6,142,105,263,175,88,172,79,595,261,334,77,65,281,172,"1800-178"
"1949",14,1,13,10,1,13,0,7,2,5,0,1,146,146,119,27,66,94,94,16,119,65,54,83,50,308,127,181,63,37,156,52,"1750-149"
"1950",18,0,18,17,0,18,0,18,0,0,0,14,143,143,121,22,5,2,108,9,121,70,51,71,39,291,152,139,42,26,177,46,"1800-131"
"1951",16,0,16,16,0,16,0,0,11,5,0,0,197,197,185,12,82,91,94,88,185,91,94,159,88,520,237,283,104,56,265,95,"1600-003"
"1952",2,2,0,2,1,1,0,1,1,0,0,1,3,3,2,1,0,1,2,0,2,1,1,2,0,6,4,2,0,0,4,2,"1800-142"
"1953",15,0,15,11,0,15,0,15,0,0,0,0,353,353,294,59,128,17,255,18,294,199,95,191,84,651,300,351,80,66,305,200,"1800-131"
"1954",0,0,0,0,0,0,0,0,0,0,0,0,0,0,0,0,0,0,0,0,0,0,0,0,0,0,0,0,0,0,0,0,"1990-096"
"1955",2,0,2,0,0,2,0,0,0,2,0,0,242,242,136,106,131,134,96,33,136,86,50,93,47,309,164,145,51,28,183,47,"1990-083"
"1956",6,0,6,6,0,6,0,0,6,0,0,0,117,117,106,11,100,106,89,11,106,63,43,64,49,241,111,130,60,13,152,16,"1600-416"
"1957",18,18,0,18,9,9,1,5,8,4,0,4,19,19,16,3,5,11,14,1,16,8,8,15,8,44,19,25,4,7,21,12,"1800-192"
"1958",33,33,0,33,22,11,0,10,21,0,2,5,34,34,32,2,7,26,30,1,32,17,15,27,12,82,39,43,7,10,40,25,"1800-192"
"1959",47,47,0,47,47,0,0,46,1,0,0,23,48,48,33,15,24,10,0,31,33,26,7,16,7,61,34,27,7,6,37,11,"1600-647"
"1960",20,20,0,20,14,6,0,1,19,0,0,1,20,20,18,2,7,16,17,0,18,9,9,12,7,46,21,25,9,4,15,18,"1800-192"
"1961",15,0,15,12,0,15,0,14,1,0,0,15,342,342,274,68,70,1,135,125,274,226,48,147,46,506,195,311,39,38,203,226,"1500-250"
"1962",4,3,1,4,4,0,3,0,1,0,0,3,9,9,8,1,4,4,2,5,8,6,2,4,1,22,15,7,1,1,17,3,"1300-125"
"1963",1,0,1,1,0,1,1,0,0,0,0,1,3,3,0,3,0,0,0,0,0,0,0,0,0,0,0,0,0,0,0,0,"1250-145"
"1964",62,61,0,62,59,3,0,62,0,0,0,24,62,61,48,13,15,45,42,3,48,27,21,42,16,143,61,82,28,6,55,54,"1700-194"
"1965",6,2,4,5,0,6,5,0,0,0,1,5,28,28,12,16,0,0,1,11,12,12,0,5,3,18,6,12,1,2,12,3,"1250-268"
"1966",15,7,8,12,6,9,11,2,2,0,0,3,53,53,32,21,5,0,8,21,32,12,20,23,13,116,79,37,14,13,79,10,"1100-289"
"1967",32,10,22,31,10,22,7,24,0,1,0,18,211,211,161,50,16,4,49,99,161,131,30,90,30,311,141,170,27,20,176,88,"1170-379"
"1968",5,4,1,5,2,3,0,4,1,0,0,3,16,16,14,2,4,2,12,0,14,9,5,15,6,36,14,22,6,2,15,13,"1400-406"
"1969",22,14,8,21,14,8,2,19,1,0,0,21,67,67,40,27,1,1,10,29,40,31,9,24,8,82,38,44,10,4,51,17,"1170-054"
"1970",96,61,35,90,62,34,16,77,1,2,0,75,321,321,197,124,15,4,55,128,197,154,43,96,45,369,156,213,47,26,213,83,"1100-474"
"1971",92,32,58,65,34,58,73,8,1,4,6,40,400,398,291,107,40,49,114,152,292,209,83,161,79,643,287,356,101,71,335,136,"1249-082"
"1972",13,2,11,11,2,11,13,0,0,0,0,12,58,58,27,31,1,0,5,21,27,20,7,11,7,54,32,22,7,6,32,9,"1250-154"
"1973",21,2,18,21,2,19,3,0,0,18,0,0,163,162,135,27,128,133,103,24,135,65,70,98,68,384,189,195,78,50,181,75,"1400-406"
"1974",11,2,9,11,1,10,5,5,0,0,1,2,52,52,33,19,2,0,14,18,33,26,7,15,4,59,26,33,5,2,32,20,"1250-169"
"1975",27,9,18,25,5,22,27,0,0,0,0,14,102,102,42,60,2,0,10,29,42,34,8,22,8,76,38,38,5,6,49,16,"1170-165"
"1976",16,0,16,15,0,16,2,11,1,0,2,3,141,141,111,30,16,14,53,52,111,81,30,73,22,233,119,114,20,17,138,58,"1170-379"
"1977",8,0,8,7,0,8,5,2,0,0,1,6,47,47,30,17,4,3,5,24,30,21,9,18,8,67,37,30,7,7,42,11,"1150-199"
"1978",7,5,2,7,4,3,3,3,1,0,0,3,13,13,11,2,2,5,6,3,11,6,5,9,5,29,15,14,8,2,11,8,"1269-093"
"1979",16,16,0,16,9,7,0,16,0,0,0,3,16,16,14,2,2,7,14,0,14,11,3,8,3,26,10,16,2,2,14,8,"1400-036"
"1980",16,16,0,16,14,2,0,16,0,0,0,0,16,16,14,2,1,5,11,1,14,8,6,12,5,34,14,20,8,0,19,7,"1400-036"
"1981",16,16,0,16,11,5,0,16,0,0,0,0,16,16,13,3,3,2,10,3,13,7,6,7,7,33,15,18,8,5,17,3,"1400-036"
"1982",12,12,0,12,3,9,0,9,1,2,0,0,12,12,11,1,3,8,10,0,11,6,5,7,5,25,6,19,5,5,9,6,"1400-406"
"1983",13,0,13,11,0,13,1,11,0,1,0,11,86,86,57,29,0,0,24,22,57,46,11,26,13,105,48,57,12,4,74,15,"1170-379"
"1984",7,1,5,4,1,6,1,4,1,1,0,5,63,62,41,21,13,9,16,20,41,28,13,25,10,131,50,81,6,18,53,54,"1050-065"
"1985",15,0,15,12,0,15,1,13,0,0,1,10,143,143,96,47,12,16,42,51,96,58,38,58,28,236,114,122,29,32,134,41,"1000-082"
"1986",21,0,18,19,0,21,0,0,21,0,0,15,487,484,416,68,320,109,164,229,420,206,214,308,165,1137,530,607,164,157,654,162,"1950"
"1987",8,0,8,8,0,8,0,6,2,0,0,8,121,121,80,41,16,0,15,59,80,51,29,54,18,189,85,104,19,14,92,64,"1950-005"
"1988",40,0,40,37,0,40,1,33,5,1,0,6,444,444,327,117,104,136,204,89,327,218,109,196,89,726,331,395,75,99,376,176,"1700-011"
"1989",25,0,25,23,0,25,0,18,7,0,0,2,358,358,297,61,100,100,179,103,297,222,75,182,71,605,261,344,71,47,320,167,"1500-592"
"1990",15,0,15,10,0,15,0,15,0,0,0,6,91,91,76,15,6,1,31,40,76,44,32,52,29,181,89,92,20,27,88,46,"1700-259"
"1991",14,0,14,14,0,14,0,14,0,0,0,0,118,118,94,24,1,0,22,60,94,77,17,39,17,167,71,96,15,12,93,47,"1600-211"
"1992",7,0,7,6,0,7,0,4,3,0,0,0,119,119,87,32,23,13,61,17,87,68,19,48,21,168,68,100,16,15,71,66,"1500-545"
"1993",6,1,4,6,0,6,1,0,1,4,0,1,85,84,71,13,69,71,55,12,72,40,32,52,37,184,85,99,35,24,115,10,"1950-344"
"1994",7,0,7,4,0,7,0,7,0,0,0,0,133,133,112,21,29,54,87,12,112,79,33,70,32,238,97,141,27,28,98,85,"1500-581"
"1995",14,0,13,11,0,14,0,0,0,0,14,0,422,422,261,161,233,257,169,75,261,162,99,176,116,638,317,321,145,65,398,30,"1500-441"
"1996",8,0,8,5,0,8,0,8,0,0,0,3,45,45,33,12,0,7,24,5,33,25,8,17,7,63,27,36,6,7,36,14,"1700-346"
"1997",66,33,33,60,37,29,54,12,0,0,0,26,260,260,172,88,19,26,80,79,172,124,48,99,41,366,164,202,37,36,238,55,"1199-010"
"1998",22,10,12,19,7,15,15,7,0,0,0,7,66,66,44,22,4,4,19,22,44,29,15,26,11,99,44,55,6,11,63,19,"1170-315"
"1999",22,0,22,19,0,22,1,21,0,0,0,4,207,207,156,51,6,1,79,61,156,106,50,85,32,367,187,180,34,32,241,60,"1170-347"
"2000",2,0,2,0,0,2,0,2,0,0,0,0,38,38,27,11,25,19,21,4,27,21,6,16,5,51,25,26,6,2,24,19,"1050-226"
"2001",16,16,0,16,16,0,10,6,0,0,0,0,17,17,10,7,2,6,9,1,10,6,4,6,4,22,12,10,1,5,11,5,"1070-181"
"2002",40,31,9,40,35,5,9,30,1,0,0,36,80,80,65,15,6,2,9,54,65,45,20,29,17,123,51,72,15,15,63,30,"1070-181"
"2003",12,1,11,12,1,11,0,10,1,0,1,2,79,79,60,19,6,17,24,31,60,40,20,40,21,163,87,76,17,16,113,17,"1000-237"
"2004",19,1,18,14,1,18,2,13,2,1,1,2,182,182,107,75,10,15,70,32,107,74,33,61,29,228,106,122,34,15,113,66,"1900-462"
"2005",14,2,10,8,1,13,13,0,1,0,0,0,81,79,60,19,7,18,26,27,61,35,26,37,21,156,67,89,15,23,67,51,"1050-214"
"2006",8,0,7,8,0,8,1,0,1,6,0,0,219,218,173,45,162,167,103,56,173,109,64,101,64,423,199,224,71,37,224,91,"1070-373"
"2007",48,48,0,48,48,0,0,48,0,0,0,17,48,48,33,15,16,9,1,31,33,21,12,23,8,76,38,38,3,8,39,26,"1600-647"
"2008",1,1,0,1,1,0,0,1,0,0,0,1,1,1,1,0,0,0,0,1,1,1,0,0,0,1,0,1,0,0,0,1,"1600-416"
"2009",13,0,13,12,0,13,0,0,13,0,0,2,142,142,133,9,35,6,57,72,133,87,46,103,38,336,149,187,35,40,172,89,"1600-647"
"2010",6,0,6,5,0,6,0,0,6,0,0,2,71,71,64,7,21,1,29,31,64,34,30,54,25,177,83,94,28,21,89,39,"1600-647"
"2011",17,0,17,17,0,17,0,0,0,17,0,15,308,308,264,44,221,264,223,24,264,142,122,177,121,649,297,352,140,71,359,79,"1740-441"
"2012",12,0,12,11,0,12,0,0,11,1,0,0,153,153,139,14,100,130,120,10,139,73,66,110,58,350,160,190,50,35,208,57,"1600-188"
"2013",23,3,20,21,3,20,21,2,0,0,0,12,113,113,80,33,2,1,37,38,80,52,28,48,22,185,78,107,28,17,102,38,"1600-993"
"2014",15,0,15,12,0,15,12,3,0,0,0,9,90,90,75,15,6,0,26,40,75,60,15,33,13,138,67,71,14,15,75,34,"1600-069"
"2015",2,0,1,2,1,1,0,1,0,0,1,1,6,5,4,1,0,0,3,1,4,3,1,2,1,8,2,6,1,0,4,3,"1000-192"
"2016",18,0,17,17,0,18,2,7,4,4,1,5,105,104,70,34,11,21,46,18,70,51,19,36,11,165,74,91,13,9,83,60,"1600-021"
"2017",29,20,8,29,27,2,16,3,10,0,0,13,81,80,41,39,10,3,7,28,41,28,13,27,15,103,57,46,13,13,54,23,"1950-052"
"2018",13,1,12,10,1,12,2,3,6,1,1,4,114,114,64,50,36,34,37,16,64,37,27,44,23,172,77,95,33,23,80,36,"1050-189"
"2019",14,0,14,13,0,14,0,0,14,0,0,14,271,271,244,27,193,6,92,143,244,130,114,216,78,642,303,339,56,59,383,144,"1950-347"
"2020",15,0,15,15,0,15,0,7,8,0,0,15,209,209,185,23,22,8,4,174,186,104,82,153,62,519,239,280,84,53,251,131,"1950-347"
"2021",47,46,0,47,47,0,9,37,0,1,0,41,49,47,38,9,21,21,7,17,38,17,21,37,14,194,138,56,10,18,137,29,"1500-624"
"2022",24,23,1,24,23,1,24,0,0,0,0,23,39,39,17,10,2,0,0,15,29,17,12,17,12,69,30,39,20,8,30,11,"1900-383"
"2023",8,0,7,5,0,8,7,1,0,0,0,2,65,64,48,16,7,8,19,26,48,29,19,32,20,135,54,81,26,13,58,38,"1000-149"
"2024",2,0,2,1,0,2,0,2,0,0,0,2,15,15,10,5,1,0,3,4,10,9,1,4,1,15,6,9,1,0,13,1,"1070-067"
"2025",52,38,14,51,44,8,35,15,2,0,0,39,122,122,82,40,11,3,15,65,82,52,30,52,23,186,88,98,24,24,92,46,"1950-052"
"2026",13,0,13,12,0,13,0,7,6,0,0,0,153,153,140,13,23,3,70,66,140,84,56,109,53,346,166,180,40,37,199,70,"1500-900"
"2027",13,0,13,13,0,13,0,2,11,0,0,13,249,249,220,29,96,3,50,96,220,113,107,191,105,646,312,334,99,94,334,119,"1900-916"
"2028",10,0,10,10,0,10,0,4,6,0,0,0,220,220,169,51,57,158,136,13,169,104,65,119,52,407,200,207,41,46,219,101,"1900-142"
"2029",6,0,6,5,0,6,0,1,5,0,0,6,102,102,91,11,14,0,63,25,91,55,36,60,32,211,90,121,29,26,106,50,"1500-900"
"2030",0,0,0,0,0,0,0,0,0,0,0,0,0,0,0,0,0,0,0,0,0,0,0,0,0,0,0,0,0,0,0,0,"1500-462"
"2031",14,0,13,13,1,13,0,9,0,3,2,2,136,135,80,55,32,44,47,23,80,47,33,55,34,221,99,122,28,29,116,48,"1050-036"
"2032",16,0,16,13,0,16,1,14,1,0,0,8,158,158,120,38,18,28,62,49,120,85,35,65,33,253,118,135,36,21,138,58,"1900-221"
"2033",19,0,19,18,0,19,0,0,19,0,0,15,281,281,248,33,72,3,126,104,248,175,73,140,61,522,223,299,62,50,267,143,"1500-900"
"2034",11,3,8,8,4,7,5,0,2,4,0,4,33,33,16,17,2,0,0,16,16,11,5,9,4,35,17,18,6,1,19,9,"1100-213"
"2035",8,1,7,3,0,8,8,0,0,0,0,7,27,27,16,11,0,0,5,10,16,14,2,5,2,29,17,12,2,2,19,6,"1200-383"
"2036",10,4,6,8,4,6,0,10,0,0,0,6,50,50,39,11,2,5,35,2,39,25,14,25,12,85,40,45,9,9,44,23,"1800-245"
"2037",6,0,6,4,0,6,0,0,0,5,1,0,184,184,110,74,107,110,79,23,110,59,51,73,54,269,133,136,68,21,163,17,"1990-192"
"2038",13,0,12,11,0,13,0,0,9,4,0,0,234,233,165,68,160,165,133,26,165,83,82,126,79,505,233,272,101,50,229,125,"1990-197"
"2039",4,0,4,2,0,4,0,0,0,4,0,0,94,94,64,30,60,64,30,29,64,59,5,22,6,96,50,46,9,4,78,5,"1990-523"
"2040",3,0,3,1,0,3,0,0,0,3,0,0,79,79,56,23,53,55,24,29,56,43,13,24,14,100,54,46,18,8,70,4,"1990-514"
"2041",7,2,5,6,3,4,0,5,0,2,0,2,72,72,53,19,5,24,35,14,53,27,26,44,31,140,60,80,31,18,79,12,"1750-462"
"2042",3,0,3,0,0,3,0,0,0,3,0,0,75,75,55,20,52,55,21,30,55,45,10,22,14,96,40,56,19,2,71,4,"1990-514"
"2043",9,0,9,8,0,9,0,0,0,9,0,6,159,159,123,36,26,40,63,52,123,48,75,104,72,387,164,223,106,55,194,32,"1750-462"
"2044",6,0,6,2,0,6,0,0,0,6,0,0,145,145,103,42,101,103,57,38,103,86,17,45,20,178,83,95,24,10,138,6,"1990-514"
"2045",0,0,0,0,0,0,0,0,0,0,0,0,0,0,0,0,0,0,0,0,0,0,0,0,0,0,0,0,0,0,0,0,"2680-048"
"2046",16,3,12,14,6,10,0,2,9,5,0,12,113,112,102,8,5,8,10,88,104,53,51,81,50,312,153,159,78,45,137,52,"1750-462"
"2047",10,4,6,10,6,4,0,9,1,0,0,6,56,56,48,8,8,16,3,40,48,32,16,33,14,109,52,57,20,8,63,18,"1750-111"
"2048",2,0,2,0,0,2,0,0,0,2,0,0,64,64,48,16,46,47,23,22,48,40,8,18,10,79,38,41,13,3,60,3,"1990-514"
"2049",9,0,9,9,0,9,0,0,0,9,0,6,148,148,116,32,33,66,67,37,116,64,52,91,63,310,153,157,70,47,175,18,"1750-462"
"2050",22,0,22,20,0,22,0,22,0,0,0,22,283,283,222,61,38,59,164,40,222,171,51,116,40,421,199,222,37,28,210,146,"1500-112"
"2051",10,0,10,8,0,10,0,10,0,0,0,0,189,189,151,38,21,61,103,31,151,107,44,94,33,313,137,176,29,24,133,127,"1600-154"
"2052",44,0,44,37,0,44,0,44,0,0,0,34,470,470,351,119,20,17,190,130,351,263,88,167,74,686,292,394,75,66,341,204,"1700-264"
"2053",7,0,7,3,0,7,0,7,0,0,0,0,157,157,127,30,28,28,74,38,127,96,31,67,25,244,100,144,22,23,118,81,"1500-581"
"2054",27,0,27,23,0,27,0,0,0,27,0,0,819,819,636,183,575,631,471,118,636,345,291,442,297,1619,796,823,374,175,973,97,"1600-075"
"2055",31,0,31,26,0,31,5,26,0,0,0,31,378,378,297,81,18,73,160,113,297,242,55,152,54,544,227,317,58,38,267,181,"1500-592"
"2056",6,0,6,5,0,6,0,0,6,0,0,6,239,239,224,15,186,5,35,180,224,124,100,165,91,584,284,300,79,86,327,92,"1600-256"
"2057",14,0,14,14,0,14,0,14,0,0,0,6,122,122,90,32,3,0,28,55,90,75,15,39,14,156,72,84,12,11,83,50,"1600-154"
"2058",12,0,12,11,0,12,0,0,12,0,0,0,329,329,242,87,162,2,0,241,242,150,92,206,38,580,282,298,24,31,355,170,"1849-001"
"2059",20,0,20,18,0,20,0,0,13,7,0,18,395,395,317,78,171,230,224,63,317,213,104,206,93,686,312,374,85,50,383,168,"1600-613"
"2060",10,0,10,8,0,10,0,10,0,0,0,4,72,72,52,20,7,0,16,33,52,29,23,30,20,124,60,64,17,24,54,29,"1700-259"
"2061",6,0,6,6,0,6,0,6,0,0,0,6,79,79,52,27,5,0,29,19,52,41,11,24,8,94,49,45,10,5,50,29,"1500-545"
"2062",4,1,2,4,3,1,4,0,0,0,0,4,8,7,6,1,2,1,2,2,6,5,1,2,0,15,10,5,0,2,7,6,"1649-003"
"2063",11,0,11,10,0,11,0,0,0,11,0,0,171,171,150,21,149,150,108,35,150,85,65,102,67,363,170,193,47,68,195,53,"1600-211"
"2064",10,0,10,9,0,10,0,0,6,4,0,0,285,285,233,52,226,227,194,19,233,136,97,170,97,580,274,306,94,73,326,87,"1500-359"
"2065",9,0,9,8,0,9,0,0,8,1,0,0,188,188,161,27,115,158,134,16,161,89,72,110,53,400,184,216,41,56,226,77,"1600-224"
"2066",8,0,8,8,0,8,0,0,8,0,0,0,103,103,90,13,40,89,70,12,90,61,29,59,29,199,90,109,31,18,92,58,"1600-211"
"2067",6,0,6,2,0,6,0,6,0,0,0,1,108,108,85,23,24,3,73,8,85,66,19,49,16,168,79,89,16,13,71,68,"1500-581"
"2068",61,60,1,61,61,0,1,52,2,3,3,2,64,64,49,15,7,7,38,5,49,28,21,35,14,117,50,67,18,6,50,43,"1400-081"
"2069",0,0,0,0,0,0,0,0,0,0,0,0,0,0,0,0,0,0,0,0,0,0,0,0,0,0,0,0,0,0,0,0,"1350-297"
"2070",25,10,15,22,9,16,19,6,0,0,0,14,129,129,89,40,9,1,8,81,89,78,11,39,13,156,71,85,12,13,85,46,"1100-359"
"2071",68,26,42,54,31,37,43,17,1,2,5,1,261,261,149,112,7,2,40,100,149,118,31,60,25,281,140,141,29,28,171,53,"1200-822"
"2072",21,4,17,15,5,16,16,1,0,4,0,12,84,84,53,31,1,1,5,44,53,40,13,18,9,111,58,53,15,8,70,18,"1100-495"
"2073",14,1,13,10,0,14,13,0,0,1,0,5,66,66,48,18,6,1,13,30,48,29,19,22,9,134,93,41,4,22,91,17,"2250-301"
"2074",8,0,8,8,0,8,0,8,0,0,0,8,160,160,133,27,18,0,38,87,133,81,52,93,37,314,166,148,35,39,145,95,"1600-647"
"2075",15,0,14,14,0,15,0,0,0,15,0,12,221,220,200,20,181,4,23,173,200,131,69,128,61,452,216,236,56,48,250,98,"1600-484"
"2076",42,41,0,42,40,2,0,41,1,0,0,7,43,42,35,7,10,26,32,3,35,12,23,26,18,110,58,52,18,18,58,16,"1800-192"
"2077",59,58,0,59,41,18,0,56,3,0,0,9,59,58,45,13,19,41,39,4,45,25,20,30,15,104,48,56,9,10,54,31,"1800-364"
"2078",10,0,10,8,0,10,0,0,10,0,0,0,225,225,184,41,159,178,154,15,184,111,73,135,59,442,202,240,74,36,185,147,"1750-151"
"2079",100,100,0,100,99,1,1,73,26,0,0,81,100,100,30,70,4,1,1,26,30,19,11,16,7,62,32,30,9,7,22,24,"1675-632"
"2080",16,0,16,16,0,16,0,14,1,1,0,0,251,251,203,48,38,142,157,23,203,145,58,111,50,414,194,220,49,31,193,141,"1600-489"
"2081",17,4,13,16,0,17,0,0,6,9,2,0,223,223,188,35,140,188,147,28,188,103,85,130,92,473,232,241,115,42,294,22,"1600-488"
"2082",0,0,0,0,0,0,0,0,0,0,0,0,0,0,0,0,0,0,0,0,0,0,0,0,0,0,0,0,0,0,0,0,"1600-489"
"2083",11,0,11,11,0,11,0,0,6,5,0,2,262,262,182,80,168,179,123,45,182,131,51,90,57,376,187,189,69,30,258,19,"1600-188"
"2084",16,0,16,14,0,16,0,15,1,0,0,9,151,151,118,33,8,0,31,81,118,88,30,56,22,232,106,126,28,12,125,67,"1170-315"
"2085",34,0,34,29,8,26,15,16,1,1,1,19,296,296,233,63,48,64,99,115,233,167,66,131,54,508,232,276,56,47,295,110,"1000-237"
"2086",2,1,0,2,2,0,1,0,1,0,0,1,3,2,2,0,1,2,0,0,2,2,0,0,0,120,37,83,0,0,6,114,"1070-181"
"2087",27,7,18,23,10,17,11,13,2,0,1,21,173,169,130,39,7,12,38,83,133,88,45,76,38,342,188,154,37,28,194,83,"1900-440"
"2088",25,4,21,19,1,24,10,8,5,1,1,13,155,155,111,44,52,62,58,44,111,64,47,65,34,277,150,127,32,37,161,47,"1050-234"
"2089",3,1,2,1,0,3,3,0,0,0,0,0,5,5,5,0,0,0,0,5,5,2,3,4,2,16,9,7,2,4,9,1,"1100-048"
"2090",8,1,7,6,1,7,8,0,0,0,0,4,42,42,28,14,0,0,4,23,28,21,7,15,7,57,27,30,3,7,35,12,"1200-056"
"2091",24,6,18,20,1,23,23,1,0,0,0,12,86,86,70,16,7,2,23,42,70,57,13,34,11,138,58,80,14,5,75,44,"1200"
"2092",8,1,7,5,0,8,8,0,0,0,0,4,26,26,15,11,1,1,2,12,15,11,4,8,3,31,16,15,4,1,19,7,"1200-260"
"2093",0,0,0,0,0,0,0,0,0,0,0,0,0,0,0,0,0,0,0,0,0,0,0,0,0,0,0,0,0,0,0,0,"1100-060"
"2094",8,1,7,4,0,8,6,1,1,0,0,7,56,56,34,22,5,2,19,15,34,22,12,20,9,76,34,42,12,3,47,14,"1100-072"
"2095",5,1,4,3,0,5,5,0,0,0,0,5,19,19,9,10,2,0,2,7,9,9,0,6,1,17,9,8,1,0,10,6,"1100-404"
"2096",2,0,1,1,0,2,2,0,0,0,0,1,3,2,1,1,0,0,0,1,1,1,0,1,0,5,2,3,0,1,2,2,"1100-576"
"2097",7,0,7,5,1,6,3,0,3,1,0,0,63,63,24,39,6,14,21,2,24,20,4,13,5,45,21,24,4,3,25,13,"1200-106"
"2098",17,8,9,14,0,17,16,0,0,1,0,3,57,57,29,28,5,5,11,17,29,18,11,19,11,73,34,39,16,9,30,18,"1200-701"
"2099",3,0,3,2,0,3,1,2,0,0,0,2,20,20,10,10,1,0,2,8,10,8,2,3,1,18,12,6,0,1,15,2,"1200-106"
"2100",21,0,21,11,0,21,21,0,0,0,0,4,83,83,42,41,1,2,22,19,42,33,9,18,5,74,38,36,4,4,51,15,"1200-096"
"2101",7,2,5,5,1,6,5,0,2,0,0,1,44,44,20,24,13,13,12,7,20,16,4,11,2,38,20,18,4,1,16,17,"1100-048"
"2102",14,2,12,9,1,13,10,0,1,1,2,6,66,66,35,31,2,1,13,20,35,25,10,21,8,77,36,41,11,4,43,19,"1250-127"
"2103",20,4,16,14,2,18,16,4,0,0,0,14,81,81,52,29,3,1,21,29,52,42,10,21,9,106,49,57,6,9,71,20,"1250-118"
"2104",13,5,8,10,1,12,7,5,1,0,0,3,59,59,31,28,5,6,12,18,31,24,7,11,6,58,35,23,7,4,38,9,"1250-156"
"2105",16,4,12,15,6,10,7,6,0,2,1,8,74,74,53,21,5,13,12,40,53,41,12,27,12,102,51,51,10,6,65,21,"1170-376"
"2106",59,52,2,59,5,54,0,50,8,1,0,4,69,64,52,12,12,49,43,4,52,25,27,41,21,227,95,132,30,15,84,98,"1849-017"
"2107",5,1,4,4,1,4,0,1,0,4,0,1,118,118,90,28,87,87,61,19,90,60,30,46,29,189,88,101,23,22,124,20,"1849-003"
"2108",10,0,10,10,0,10,0,5,5,0,0,10,94,94,88,6,23,0,21,66,88,48,40,72,32,229,105,124,22,32,132,43,"1600-003"
"2109",5,0,5,4,0,5,0,3,2,0,0,0,339,339,276,63,155,35,186,79,276,196,80,174,56,575,271,304,45,46,295,189,"1950-004"
"2110",27,0,27,26,0,27,0,10,17,0,0,21,309,309,268,41,108,8,161,98,268,149,119,217,91,699,308,391,78,76,370,175,"1950-136"
"2111",11,0,11,8,0,11,0,0,11,0,0,11,268,268,227,41,39,16,192,24,227,148,79,156,63,504,241,263,58,34,238,174,"1500-998"
"2112",17,0,17,17,0,17,3,14,0,0,0,0,311,311,240,71,61,6,138,82,240,183,57,132,51,460,197,263,54,27,203,176,"1500-250"
"2113",15,0,15,10,0,15,0,15,0,0,0,9,94,94,72,22,2,1,37,31,72,52,20,40,20,154,73,81,20,22,72,40,"1700-237"
"2114",16,0,16,14,0,16,0,16,0,0,0,10,114,114,98,16,3,6,69,20,98,62,36,56,29,215,100,115,31,17,111,56,"1700"
"2115",7,0,7,6,0,7,0,7,0,0,0,3,123,123,94,29,15,0,43,44,94,78,16,40,9,161,64,97,7,12,66,76,"1500-547"
"2116",9,0,9,8,0,9,0,0,1,8,0,0,144,144,105,39,90,105,74,30,105,53,52,77,54,271,130,141,60,32,153,26,"1990-136"
"2117",11,0,10,9,1,10,0,3,7,1,0,11,120,119,100,19,60,11,49,45,100,63,37,68,26,240,122,118,22,18,145,55,"1500-450"
"2118",8,0,8,6,0,8,0,4,4,0,0,8,374,374,313,61,143,114,238,35,313,228,85,179,68,631,287,344,69,45,297,220,"1500-023"
"2119",4,0,4,3,0,4,0,4,0,0,0,0,177,177,154,23,89,97,125,13,154,98,56,103,40,357,154,203,43,27,169,118,"1500-023"
"2120",21,3,18,18,3,18,13,7,0,1,0,2,103,103,78,25,8,10,39,29,78,51,27,49,25,174,75,99,28,18,92,36,"1200-662"
"2121",1,1,0,1,0,1,1,0,0,0,0,0,1,1,1,0,1,0,0,1,1,1,0,0,0,1,1,0,0,0,1,0,"1100-200"
"2122",32,32,0,32,32,0,0,32,0,0,0,5,32,32,25,7,5,3,20,3,25,18,7,17,7,52,25,27,6,4,25,17,"1400-081"
"2123",55,24,31,49,21,34,53,2,0,0,0,37,181,181,102,79,22,14,40,56,102,71,31,55,25,214,96,118,21,25,118,50,"1100-216"
"2124",21,7,14,15,8,13,19,1,1,0,0,7,69,69,44,25,0,0,15,28,44,35,9,19,5,79,34,45,2,7,45,25,"1100-019"
"2125",17,0,17,15,0,17,13,2,0,2,0,6,109,109,71,38,3,7,20,46,71,61,10,30,9,125,56,69,7,8,86,24,"1200-366"
"2126",42,23,19,29,24,18,35,6,1,0,0,28,130,130,75,55,4,3,34,38,75,56,19,46,13,153,78,75,13,10,89,41,"1100-122"
"2127",25,1,24,14,1,24,12,8,0,4,1,15,175,175,120,55,7,3,39,70,120,96,24,51,19,209,103,106,13,13,137,46,"1249-280"
"2128",13,3,10,7,4,9,13,0,0,0,0,4,49,49,31,18,2,0,10,12,31,30,1,8,1,42,19,23,0,1,28,13,"1200-296"
"2129",9,9,0,8,9,0,9,0,0,0,0,6,17,17,13,4,4,2,13,0,13,5,8,10,6,35,18,17,5,3,19,8,"1300-052"
"2130",22,1,21,11,0,22,22,0,0,0,0,21,102,102,51,51,2,0,22,24,51,40,11,22,10,99,55,44,13,6,54,26,"1200-043"
"2131",1,0,1,1,0,1,0,1,0,0,0,0,6,6,1,5,0,0,0,1,1,1,0,1,0,2,1,1,0,0,1,1,NA
"2132",6,5,1,5,6,0,5,0,1,0,0,2,12,12,11,1,4,2,9,1,11,8,3,7,4,23,11,12,1,4,12,6,"1300-053"
"2133",18,5,13,7,3,15,12,3,0,3,0,9,62,62,33,29,2,2,18,14,33,31,2,13,1,51,24,27,0,3,36,12,"1200-311"
"2134",77,66,11,77,71,6,46,29,1,0,1,69,136,136,110,26,17,9,18,87,110,71,39,69,43,268,126,142,56,34,143,35,"1300-125"
"2135",5,2,2,5,1,4,0,4,1,0,0,1,12,11,6,5,0,0,0,3,6,2,4,4,2,23,16,7,5,1,15,2,"1169-060"
"2136",19,2,17,8,1,18,19,0,0,0,0,17,76,76,48,28,4,1,10,35,48,35,13,20,10,94,47,47,11,8,61,14,"1200-385"
"2137",8,1,7,6,1,7,7,0,0,1,0,1,26,26,15,11,2,6,10,5,15,9,6,10,7,40,18,22,11,4,19,6,"1200-293"
"2138",11,4,7,10,2,9,11,0,0,0,0,9,48,48,28,20,2,3,6,20,28,23,5,12,5,47,23,24,5,5,24,13,"1200-293"
"2139",10,3,7,7,1,9,10,0,0,0,0,7,36,36,27,9,3,0,3,24,27,20,7,16,8,57,23,34,8,6,32,11,"1200-236"
"2140",35,19,16,27,20,15,35,0,0,0,0,24,91,91,60,31,2,2,17,39,60,50,10,25,7,103,44,59,10,7,60,26,"1100-572"
"2141",0,0,0,0,0,0,0,0,0,0,0,0,0,0,0,0,0,0,0,0,0,0,0,0,0,0,0,0,0,0,0,0,"1200-470"
"2142",2,1,0,2,1,1,2,0,0,0,0,1,2,1,1,0,1,0,0,0,1,1,0,1,0,37,1,36,0,1,30,6,"1200-220"
"2143",9,0,9,5,1,8,9,0,0,0,0,7,42,42,27,15,1,0,2,23,27,21,6,9,5,49,30,19,3,2,35,9,"1200-249"
"2144",14,1,13,9,1,13,13,0,0,1,0,8,70,70,36,34,2,2,13,21,36,30,6,18,6,65,31,34,4,6,39,16,"1200-192"
"2145",0,0,0,0,0,0,0,0,0,0,0,0,0,0,0,0,0,0,0,0,0,0,0,0,0,7,7,0,0,1,5,1,"1300-052"
"2146",0,0,0,0,0,0,0,0,0,0,0,0,0,0,0,0,0,0,0,0,0,0,0,0,0,0,0,0,0,0,0,0,"1250-238"
"2147",11,3,8,7,3,8,10,0,1,0,0,0,47,47,24,23,1,2,12,10,24,17,7,13,5,51,23,28,3,8,26,14,"1200-192"
"2148",29,13,16,21,15,14,26,1,2,0,0,17,73,73,55,18,3,0,13,39,55,41,14,23,12,121,70,51,7,15,77,22,"1100-591"
"2149",9,5,4,9,5,4,9,0,0,0,0,8,34,34,28,6,4,4,22,3,28,18,10,16,9,61,29,32,8,6,26,21,"1300-052"
"2150",9,8,1,9,8,1,8,0,0,1,0,0,18,18,17,1,5,3,12,4,17,7,10,15,8,47,22,25,7,4,23,13,"1300-053"
"2151",12,1,11,6,1,11,1,10,0,0,1,8,101,101,64,37,16,9,28,29,64,35,29,47,22,176,84,92,20,30,101,25,"1050-206"
"2152",18,12,6,17,12,6,17,1,0,0,0,11,46,46,25,21,0,0,14,9,25,18,7,15,7,56,29,27,9,2,34,11,"1900-194"
"2153",37,37,0,37,27,10,0,37,0,0,0,9,38,38,33,5,7,21,28,3,33,18,15,20,12,76,37,39,9,10,37,20,"1900-107"
"2154",42,42,0,42,37,5,36,2,2,1,1,6,44,44,33,11,4,8,16,16,33,30,3,14,3,55,29,26,6,0,28,21,"1900-311"
"2155",24,0,22,20,0,24,7,12,4,1,0,16,229,227,163,64,42,28,76,63,164,111,53,89,32,404,208,196,29,36,275,64,"1150-021"
"2156",0,0,0,0,0,0,0,0,0,0,0,0,0,0,0,0,0,0,0,0,0,0,0,0,0,0,0,0,0,0,0,0,"1150-021"
"2157",38,21,17,33,22,16,0,21,5,12,0,38,225,225,199,26,71,25,34,154,199,72,127,179,112,710,356,354,188,99,360,63,"1750-111"
"2158",15,15,0,15,15,0,0,15,0,0,0,1,15,15,12,3,6,11,11,1,12,5,7,7,4,34,15,19,5,5,18,6,"1800-129"
"2159",9,0,9,5,0,9,0,5,2,2,0,8,119,119,71,48,14,4,24,34,71,56,15,38,12,140,59,81,14,14,71,41,"1600-466"
"2160",5,0,5,4,0,5,0,5,0,0,0,0,59,59,51,8,19,0,46,2,51,31,20,35,16,121,59,62,8,24,48,41,"1800-125"
"2161",4,0,4,4,0,4,0,4,0,0,0,1,65,65,52,13,49,2,39,4,52,36,16,29,11,110,47,63,12,8,53,37,"1800-125"
"2162",32,0,32,27,0,32,0,0,13,15,4,7,608,608,457,151,357,450,357,71,457,266,191,314,195,1117,535,582,214,117,666,120,"1600-641"
"2163",8,0,8,8,0,8,0,0,8,0,0,0,221,221,179,42,115,176,148,18,179,107,72,133,62,431,203,228,45,62,229,95,"1600-297"
"2164",5,0,5,5,0,5,0,0,5,0,0,0,78,78,73,5,62,69,65,5,73,42,31,56,22,175,93,82,15,21,89,50,"1600-548"
"2165",21,21,0,21,21,0,0,21,0,0,0,0,21,21,18,3,10,17,16,2,18,9,9,10,7,54,26,28,12,6,27,9,"1800-129"
"2166",3,0,3,3,0,3,0,3,0,0,0,0,102,102,85,17,58,0,74,3,85,53,32,61,25,190,86,104,17,23,92,58,"1800-105"
"2167",12,6,6,11,6,6,4,6,1,1,0,8,51,51,25,26,14,21,19,3,25,9,16,25,11,80,41,39,14,7,42,17,"1750-147"
"2168",6,0,6,5,0,6,0,0,6,0,0,0,110,110,100,10,82,100,91,3,100,52,48,75,43,252,120,132,40,34,128,50,"1600-864"
"2169",22,22,0,22,22,0,0,21,0,1,0,1,22,22,20,2,9,18,17,1,20,6,14,19,7,65,35,30,10,5,38,12,"1800-129"
"2170",23,23,0,23,22,1,1,19,1,1,1,2,23,23,20,3,7,17,19,0,20,11,9,18,8,55,28,27,10,4,29,12,"1800-192"
"2171",20,0,19,17,0,20,0,20,0,0,0,16,286,286,223,63,60,6,165,40,223,168,55,126,50,431,184,247,46,34,204,147,"1800-048"
"2172",4,0,4,1,0,4,4,0,0,0,0,0,19,19,15,4,0,0,14,0,15,7,8,9,5,43,22,21,5,11,19,8,"1000-197"
"2173",18,1,17,17,1,17,2,14,2,0,0,0,218,218,141,77,17,17,65,57,141,109,32,66,35,274,123,151,32,27,157,58,"1070-065"
"2174",45,45,0,45,44,1,7,38,0,0,0,43,45,45,37,8,8,2,0,37,37,21,16,25,16,93,47,46,15,13,46,19,"1900-330"
"2175",23,0,21,15,0,23,1,19,1,2,0,7,173,171,132,39,36,19,50,70,132,92,40,76,31,371,150,221,37,21,172,141,"1050-038"
"2176",11,0,11,5,0,11,0,11,0,0,0,3,221,221,151,70,18,22,73,66,151,105,46,74,33,312,143,169,30,33,172,77,"1070-063"
"2177",22,0,21,16,1,21,0,20,2,0,0,0,227,226,141,85,20,16,79,52,142,111,31,69,24,268,112,156,23,15,154,76,"1070-061"
"2178",0,0,0,0,0,0,0,0,0,0,0,0,0,0,0,0,0,0,0,0,0,0,0,0,0,0,0,0,0,0,0,0,"1000-189"
"2179",22,20,2,22,3,19,17,1,2,2,0,0,31,31,23,8,2,0,20,2,23,14,9,14,9,55,22,33,9,7,29,10,"1000-189"
"2180",19,1,18,13,0,19,0,8,10,1,0,8,286,286,220,66,27,19,94,106,220,155,65,129,62,465,182,283,56,43,232,134,"1000-149"
"2181",4,3,0,4,3,1,0,0,3,1,0,3,4,3,2,1,1,0,0,1,2,2,0,0,0,82,29,53,0,0,4,78,"1500-536"
"2182",21,0,20,18,0,21,4,13,1,3,0,17,256,255,179,75,47,47,87,68,180,140,40,94,41,369,169,200,53,32,181,103,"1050-222"
"2183",4,0,4,3,0,4,4,0,0,0,0,0,22,22,20,2,0,0,17,0,20,7,13,17,11,64,34,30,13,12,33,6,"1000-197"
"2184",10,0,10,9,0,10,3,6,0,1,0,4,93,93,60,33,12,11,37,17,60,34,26,45,26,156,78,78,31,19,74,32,"1050-998"
"2185",6,0,6,3,0,6,0,0,0,6,0,0,329,329,230,99,223,230,175,44,230,162,68,150,65,502,242,260,68,42,261,131,"1549-010"
"2186",25,23,2,25,17,8,25,0,0,0,0,0,31,31,25,6,4,2,22,2,25,14,11,18,11,68,35,33,16,8,28,16,"1000-134"
"2187",22,2,20,22,1,21,13,5,0,3,1,2,113,113,84,29,10,9,45,31,84,54,30,44,32,184,81,103,35,18,102,29,"1070-091"
"2188",19,0,19,18,0,19,7,10,2,0,0,0,173,173,103,70,9,13,56,38,103,68,35,55,35,225,112,113,36,22,124,43,"1070-092"
"2189",7,0,7,6,0,7,0,1,6,0,0,3,112,112,99,12,48,2,8,53,100,56,44,76,42,258,117,141,47,29,136,46,"1900-063"
"2190",6,0,5,4,0,6,0,6,0,0,0,2,94,93,73,20,21,1,49,13,74,52,22,38,20,168,81,87,21,24,83,40,"1050-103"
"2191",10,0,10,9,0,10,0,10,0,0,0,0,63,63,50,13,3,0,35,11,50,31,19,30,14,113,55,58,24,3,59,27,"1700-013"
"2192",18,0,18,18,0,18,0,0,18,0,0,2,240,240,220,20,113,4,80,135,220,120,100,174,82,564,254,310,74,67,321,102,"1950-080"
"2193",25,0,25,23,0,25,0,21,2,2,0,8,267,267,194,73,65,32,130,55,194,152,42,112,45,385,169,216,46,23,203,113,"1500-851"
"2194",6,0,6,6,0,6,0,0,6,0,0,6,72,72,65,7,17,1,10,52,65,23,42,68,42,238,101,137,52,35,119,32,"1950-133"
"2195",3,0,3,3,0,3,0,3,0,0,0,0,91,91,74,14,34,3,45,25,77,48,29,50,15,179,77,102,23,12,75,69,"1950-244"
"2196",10,0,10,10,0,10,0,10,0,0,0,0,63,63,47,16,1,0,36,4,47,35,12,23,12,90,36,54,13,6,39,32,"1700"
"2197",21,0,21,18,0,21,0,11,10,0,0,0,354,354,275,79,88,203,225,29,275,183,92,179,79,622,285,337,62,65,281,214,"1500-185"
"2198",21,0,21,19,0,21,0,21,0,0,0,4,127,127,92,35,2,0,65,16,92,61,31,49,24,200,84,116,24,17,111,48,"1700"
"2199",7,0,6,7,0,7,0,0,7,0,0,6,163,162,133,29,119,16,14,113,133,76,57,100,44,352,164,188,29,52,193,78,"1600-251"
"2200",3,0,3,1,0,3,0,0,3,0,0,0,102,102,78,24,67,78,60,10,78,52,26,62,23,184,85,99,13,26,89,56,"1600-149"
"2201",31,0,30,28,0,31,0,0,10,21,0,1,470,469,321,148,234,318,230,58,321,195,126,238,121,810,368,442,96,118,403,193,"1600-001"
"2202",24,0,23,24,1,23,0,0,24,0,0,19,229,228,208,20,20,10,82,119,208,90,118,177,76,631,310,321,65,79,332,155,"1950-033"
"2203",3,0,3,3,0,3,0,3,0,0,0,1,210,210,185,25,83,3,74,104,185,125,60,135,44,427,199,228,49,37,176,165,"1950-211"
"2204",0,0,0,0,0,0,0,0,0,0,0,0,0,0,0,0,0,0,0,0,0,0,0,0,0,0,0,0,0,0,0,0,"1500-065"
"2205",40,2,38,37,2,38,2,33,5,0,0,0,373,373,267,106,34,53,141,109,267,206,61,138,58,509,224,285,56,31,244,178,"1500-259"
"2206",6,0,6,0,0,6,0,0,0,6,0,3,195,195,129,66,117,127,69,44,129,110,19,62,26,228,106,122,27,16,176,9,"1600-251"
"2207",5,2,3,5,2,3,0,0,2,0,3,1,81,81,6,75,5,5,5,0,6,5,1,4,1,12,5,7,0,1,10,1,"1950-421"
"2208",18,6,11,15,6,12,6,10,2,0,0,1,256,254,205,49,55,136,134,51,212,166,46,109,41,431,201,230,62,32,214,123,"1600-154"
"2209",6,0,6,4,0,6,0,6,0,0,0,3,63,63,51,12,4,2,25,23,51,33,18,34,19,117,57,60,19,12,61,25,"1700-194"
"2210",0,0,0,0,0,0,0,0,0,0,0,0,0,0,0,0,0,0,0,0,0,0,0,0,0,0,0,0,0,0,0,0,"1500-065"
"2211",9,0,9,7,0,9,0,0,1,8,0,0,138,138,84,54,81,84,47,32,84,53,31,60,38,200,108,92,45,16,126,13,"1990-196"
"2212",9,4,5,9,4,5,9,0,0,0,0,6,37,37,24,13,1,0,3,19,24,19,5,7,3,41,16,25,3,2,26,10,NA
"2213",39,39,0,39,39,0,2,37,0,0,0,11,39,39,31,8,1,4,29,1,31,17,14,29,12,82,37,45,9,11,42,20,"1400-081"
"2214",7,5,0,7,3,4,0,5,0,1,1,3,9,6,3,3,2,3,3,0,3,2,1,3,1,52,14,38,3,0,5,44,"1700-198"
"2215",16,1,14,13,2,14,3,10,1,1,1,2,164,163,125,38,21,26,61,58,125,100,25,63,29,244,103,141,26,20,117,81,"1350-039"
"2216",27,27,0,27,27,0,0,22,1,0,4,5,27,27,22,5,7,9,18,1,22,13,9,17,6,52,26,26,8,0,25,19,"1400-081"
"2217",25,10,14,21,8,17,19,4,1,0,1,7,99,98,65,33,9,11,28,28,65,46,19,37,18,144,73,71,23,7,83,31,"1200-602"
"2218",17,5,12,8,5,12,11,6,0,0,0,12,97,97,65,32,11,17,18,40,65,46,19,33,13,132,56,76,12,11,74,35,"1200-311"
"2219",26,4,22,17,6,20,25,1,0,0,0,11,132,132,76,56,8,0,8,63,76,59,17,35,7,153,87,66,6,13,105,29,"1100-034"
"2220",48,19,29,41,15,33,48,0,0,0,0,37,163,163,89,74,3,0,29,54,89,70,19,44,15,162,81,81,17,10,93,42,"1100-108"
"2221",11,0,11,4,0,11,10,0,1,0,0,4,67,67,47,20,0,1,10,34,47,31,16,26,14,111,64,47,10,14,69,18,"1100-289"
"2222",0,0,0,0,0,0,0,0,0,0,0,0,0,0,0,0,0,0,0,0,0,0,0,0,0,0,0,0,0,0,0,0,"1250-238"
"2223",15,11,4,11,10,5,11,4,0,0,0,10,25,25,22,3,3,0,5,16,22,20,2,7,3,35,16,19,4,2,22,7,"1100-471"
"2224",15,0,15,6,0,15,15,0,0,0,0,8,67,67,44,23,6,2,13,25,44,26,18,26,18,99,45,54,11,13,48,27,"1200-311"
"2225",9,4,5,9,5,4,9,0,0,0,0,6,37,37,30,7,4,5,24,5,30,19,11,18,11,64,27,37,7,8,39,10,"1300-053"
"2226",12,2,10,7,0,12,10,2,0,0,0,3,46,46,30,15,3,0,4,23,31,20,11,17,8,82,49,33,10,5,59,8,"1150-169"
"2227",26,11,15,23,11,15,22,4,0,0,0,20,92,92,42,50,2,0,6,34,42,34,8,20,6,76,34,42,5,8,51,12,"1100-116"
"2228",23,2,21,22,3,20,5,8,3,6,1,13,220,220,174,46,53,57,90,69,174,123,51,93,48,374,182,192,56,41,197,80,"1350-126"
"2229",12,0,12,7,2,10,5,3,1,2,1,1,65,65,51,14,8,14,18,27,51,36,15,28,15,104,50,54,17,6,60,21,"1249-082"
"2230",24,3,21,18,2,22,23,0,1,0,0,14,122,122,65,57,5,1,24,39,65,54,11,31,13,116,50,66,10,10,65,31,"1200-296"
"2231",12,4,8,8,3,9,12,0,0,0,0,7,50,50,31,19,1,2,10,18,31,24,7,10,3,54,26,28,5,3,31,15,"1269-127"
"2232",35,9,25,31,9,26,11,16,2,4,2,12,251,250,197,53,53,90,111,75,197,143,54,103,46,418,184,234,61,36,207,114,"1350-074"
"2233",37,0,23,17,0,37,8,27,1,0,1,6,325,324,246,78,17,13,114,108,246,186,60,116,56,469,217,252,52,41,275,101,"1600-139"
"2234",23,23,0,23,23,0,0,23,0,0,0,4,23,23,16,7,1,7,14,1,16,9,7,11,7,42,25,17,9,5,21,7,"1500-599"
"2235",14,0,14,14,0,14,0,13,0,1,0,14,151,151,132,19,33,5,70,59,132,84,48,93,29,303,134,169,26,19,146,112,"1950-157"
"2236",5,0,5,5,1,4,0,5,0,0,0,4,161,161,139,22,87,1,5,129,139,69,70,114,48,372,175,197,51,44,167,110,"1950-157"
"2237",20,20,0,20,20,0,0,19,1,0,0,5,20,20,17,3,5,11,15,2,17,8,9,13,7,47,20,27,3,9,24,11,"1500-599"
"2238",45,45,0,45,36,9,0,45,0,0,0,15,45,45,35,10,10,23,31,1,35,24,11,26,11,77,33,44,8,8,35,26,"1900-107"
"2239",8,1,7,6,2,6,2,2,2,1,1,3,49,49,25,24,9,10,7,13,25,19,6,12,3,50,26,24,5,2,28,15,"1050-116"
"2240",44,39,5,43,43,1,0,42,2,0,0,38,66,66,53,13,4,0,8,45,53,40,13,27,17,104,49,55,14,14,54,22,"1070-181"
"2241",27,27,0,27,21,6,0,27,0,0,0,13,28,28,21,7,7,13,20,1,21,14,7,14,7,49,19,30,9,4,17,19,"1900-330"
"2242",25,0,24,20,0,25,18,7,0,0,0,11,206,205,151,54,19,27,61,77,151,104,47,84,33,366,190,176,39,31,215,81,"1150-056"
"2243",33,0,33,32,0,33,2,26,4,1,0,0,378,378,278,100,31,3,120,139,278,186,92,163,73,619,286,333,59,64,354,142,"1900-339"
"2244",27,0,27,26,27,0,0,27,0,0,0,4,107,107,92,15,14,3,51,28,92,60,32,65,22,216,96,120,18,20,97,81,"1950-230"
"2245",17,0,17,17,1,16,7,8,2,0,0,0,190,190,130,60,38,60,76,47,130,95,35,77,30,262,117,145,25,29,142,66,"1500-098"
"2246",2,1,0,2,2,0,0,1,1,0,0,0,3,2,2,0,0,1,1,0,2,1,1,2,1,41,18,23,0,1,7,33,"1950-363"
"2247",38,0,38,34,0,38,0,19,5,14,0,31,397,397,304,93,101,105,99,184,304,230,74,162,66,610,275,335,56,65,343,146,"1600-198"
"2248",12,0,12,6,0,12,0,12,0,0,0,7,204,204,169,35,8,2,117,36,169,123,46,92,39,349,147,202,39,33,164,113,"1500-144"
"2249",28,0,28,26,0,28,0,28,0,0,0,0,358,358,262,96,35,11,73,164,262,180,82,132,72,550,253,297,66,59,297,128,"1000-294"
"2250",15,1,14,15,1,14,0,14,1,0,0,3,93,93,68,25,0,1,23,40,68,54,14,26,11,122,59,63,8,15,71,28,"1600-198"
"2251",8,0,8,7,0,8,0,0,0,8,0,0,87,87,51,36,49,51,43,5,51,18,33,46,33,171,82,89,49,23,86,13,"1600-467"
"2252",9,0,9,7,0,9,2,6,0,1,0,2,123,123,81,42,30,31,37,33,81,65,16,39,13,155,65,90,6,19,89,41,"1600-873"
"2253",8,0,7,7,0,8,0,5,3,0,0,3,264,264,188,76,95,153,151,18,188,118,70,114,59,429,206,223,70,46,207,106,"1600-007"
"2254",23,0,23,17,0,23,1,22,0,0,0,0,427,427,318,109,59,120,221,73,318,239,79,182,70,625,276,349,69,48,282,226,"1500-328"
"2255",16,0,16,11,0,16,0,16,0,0,0,9,153,153,113,40,19,27,41,64,113,83,30,53,23,219,88,131,22,16,120,61,"1000-011"
"2256",72,52,20,69,50,22,50,20,2,0,0,53,261,261,203,58,8,2,80,109,203,154,49,101,45,419,167,252,40,32,234,113,"1500-093"
"2257",7,0,7,5,0,7,0,0,6,1,0,7,58,58,46,12,15,1,0,45,46,24,22,39,27,141,65,76,36,25,63,17,"1500-599"
"2258",18,0,18,9,0,18,0,18,0,0,0,5,292,292,220,72,5,1,145,41,220,171,49,121,45,422,190,232,45,34,189,154,"1500-144"
"2259",24,0,24,24,24,0,0,24,0,0,0,2,96,96,85,11,12,5,53,24,85,56,29,62,14,194,87,107,16,9,86,83,"1950-230"
"2260",10,0,10,10,0,10,0,0,10,0,0,9,110,110,102,8,16,0,66,33,102,69,33,74,27,235,106,129,27,23,101,84,"1950-105"
"2261",12,0,12,12,0,12,0,0,0,12,0,2,163,163,146,17,139,142,115,24,146,63,83,110,82,387,186,201,88,36,241,22,"1950-157"
"2262",35,15,19,33,30,5,30,3,0,1,1,33,124,123,86,37,22,23,51,26,86,67,19,50,16,191,81,110,14,16,93,68,"1500-271"
"2263",6,0,4,6,0,6,0,1,1,4,0,0,56,53,47,6,43,1,0,45,48,30,18,30,16,134,51,83,21,23,57,33,"1600-198"
"2264",19,0,19,18,0,19,0,0,19,0,0,19,331,331,300,31,78,4,78,209,300,141,159,248,136,844,411,433,105,131,455,153,"1950-338"
"2265",68,63,5,68,65,3,66,2,0,0,0,65,93,93,54,39,9,0,8,43,54,33,21,38,16,129,61,68,14,19,67,29,"1300-018"
"2266",47,39,8,47,38,9,39,1,5,1,1,13,96,96,64,32,5,28,37,26,64,42,22,50,21,150,71,79,22,13,65,50,"1300-021"
"2267",23,2,20,19,2,21,8,9,4,2,0,1,185,184,139,45,44,32,58,63,139,86,53,93,44,361,163,198,64,55,175,67,"1399-011"
"2268",2,0,1,1,0,2,2,0,0,0,0,0,4,3,2,1,0,0,0,2,3,1,2,0,0,10,9,1,0,1,9,0,"1100-171"
"2269",5,1,4,3,0,5,3,2,0,0,0,4,19,19,6,13,2,0,0,6,6,6,0,2,0,8,3,5,0,0,5,3,"1150-265"
"2270",8,0,8,7,0,8,0,8,0,0,0,2,194,194,163,31,108,1,133,14,163,106,57,116,51,400,176,224,47,49,180,124,"1800-088"
"2271",1,0,0,1,0,1,0,0,1,0,0,0,1,0,0,0,0,0,0,0,0,0,0,0,0,54,12,42,0,0,2,52,"1500-210"
"2272",22,22,0,22,22,0,0,22,0,0,0,1,22,22,18,4,7,16,18,0,18,9,9,16,6,55,29,26,14,3,24,14,"1800-129"
"2273",8,0,8,7,0,8,0,8,0,0,0,5,127,127,100,27,52,3,87,6,100,76,24,58,20,193,77,116,16,13,79,85,"1800-125"
"2274",114,114,0,114,90,24,0,88,26,0,0,0,114,114,92,22,21,31,61,22,92,65,27,57,16,198,96,102,16,13,84,85,"1600-645"
"2275",21,1,19,20,2,19,0,2,19,0,0,3,334,333,283,50,234,271,231,33,283,182,101,202,95,697,352,345,93,75,357,172,"1600-764"
"2276",11,0,11,10,1,10,0,1,10,0,0,6,363,363,289,74,53,83,242,28,289,195,94,169,74,607,286,321,65,56,295,191,"1600-641"
"2277",7,1,6,6,1,6,1,0,6,0,0,0,254,254,221,33,204,219,167,37,221,138,83,134,80,500,236,264,77,67,307,49,"1600-587"
"2278",4,0,4,2,0,4,0,0,4,0,0,2,86,86,80,6,25,0,69,6,80,56,24,48,21,173,75,98,23,11,84,55,"1600-641"
"2279",0,0,0,0,0,0,0,0,0,0,0,0,0,0,0,0,0,0,0,0,0,0,0,0,0,0,0,0,0,0,0,0,"1990"
"2280",17,0,17,1,0,17,0,8,9,0,0,17,480,480,339,141,170,326,248,48,339,255,84,168,78,661,311,350,82,43,421,115,"1600-428"
"2281",5,0,5,5,0,5,0,5,0,0,0,1,53,53,45,8,18,0,38,4,45,29,16,28,9,97,40,57,10,6,50,31,"1800"
"2282",0,0,0,0,0,0,0,0,0,0,0,0,0,0,0,0,0,0,0,0,0,0,0,0,0,0,0,0,0,0,0,0,"1990-083"
"2283",6,0,6,5,0,6,0,6,0,0,0,2,81,81,69,12,21,0,55,6,69,51,18,45,18,150,72,78,20,14,61,55,"1800-071"
"2284",8,0,8,7,0,8,0,8,0,0,0,6,68,68,53,15,7,0,42,6,53,35,18,37,19,125,52,73,11,17,64,33,"1800-100"
"2285",2,0,2,1,0,2,0,0,0,2,0,0,59,59,50,9,48,50,0,50,50,33,17,27,19,102,49,53,20,7,71,4,"1990-514"
"2286",24,18,6,24,18,6,0,18,0,6,0,22,67,67,58,8,24,40,30,24,59,26,33,46,32,168,76,92,33,24,99,12,"1750-478"
"2287",8,2,6,7,2,6,0,3,5,0,0,8,57,57,49,8,2,2,6,41,49,24,25,39,24,136,58,78,28,17,61,30,"1750-111"
"2288",11,0,11,7,0,11,0,11,0,0,0,2,162,162,135,27,51,1,76,47,135,111,24,76,17,253,104,149,21,14,100,118,"1500-613"
"2289",17,0,16,11,0,17,15,2,0,0,0,17,104,103,84,19,2,9,21,51,84,61,23,47,26,183,84,99,32,14,104,33,"1700-237"
"2290",10,0,10,7,0,10,0,10,0,0,0,7,60,60,52,8,2,0,38,8,52,40,12,27,15,101,48,53,14,9,59,19,"1700-013"
"2291",68,20,47,66,22,46,36,30,0,0,2,54,391,390,297,93,21,27,120,167,299,237,62,141,55,655,275,380,55,32,337,231,"1070-271"
"2292",9,1,8,8,0,9,1,6,0,2,0,0,93,93,61,32,12,16,35,21,61,39,22,41,20,147,69,78,20,18,85,24,"1050-229"
"2293",9,1,8,6,1,8,6,3,0,0,0,1,46,46,25,21,3,2,13,11,25,14,11,19,11,62,28,34,9,8,37,8,"1050-110"
"2294",25,2,22,19,2,23,13,5,1,3,3,7,186,185,129,56,18,28,65,50,129,93,36,58,26,274,131,143,34,22,174,44,"1000-008"
"2295",16,16,0,16,15,1,15,0,1,0,0,2,16,16,12,4,3,9,10,0,12,8,4,9,4,29,14,15,6,1,12,10,"1070-181"
"2296",9,0,9,9,0,9,0,0,2,7,0,9,132,132,112,20,73,111,97,10,112,63,49,89,48,295,141,154,48,39,150,58,"1750-170"
"2297",8,0,8,6,0,8,0,7,1,0,0,8,195,195,157,38,67,142,128,11,157,108,49,107,43,361,170,191,46,37,143,135,"1750-155"
"2298",3,1,2,2,1,2,0,3,0,0,0,1,92,92,81,11,56,2,65,10,81,48,33,51,29,189,78,111,33,14,98,44,"1849-029"
"2299",11,0,11,11,0,11,0,0,11,0,0,1,98,98,85,13,81,84,66,10,85,50,35,52,35,198,96,102,38,19,115,26,"1600-805"
"2300",5,0,5,3,0,5,0,5,0,0,0,1,90,90,77,13,36,35,37,27,77,36,41,60,34,208,97,111,26,21,113,48,"1800-129"
"2301",9,0,9,9,0,9,0,0,9,0,0,0,143,143,129,14,90,128,103,21,129,72,57,85,58,322,150,172,58,47,198,19,NA
"2302",20,0,20,16,0,20,0,19,0,1,0,0,247,247,213,34,75,30,130,57,213,145,68,125,59,461,217,244,75,39,223,124,"1600-488"
"2303",0,0,0,0,0,0,0,0,0,0,0,0,0,0,0,0,0,0,0,0,0,0,0,0,0,0,0,0,0,0,0,0,"1849-029"
"2304",1,0,1,0,0,1,0,1,0,0,0,1,69,69,64,5,41,1,15,39,64,24,40,59,34,209,101,108,34,30,113,32,"1800-111"
"2305",28,7,21,27,8,20,8,5,14,1,0,15,320,320,280,40,122,39,154,109,280,166,114,199,91,692,335,357,76,76,382,158,"1800-048"
"2306",15,15,0,15,15,0,13,2,0,0,0,1,15,15,11,4,3,6,10,0,11,9,2,9,1,22,9,13,1,0,8,13,"1070-181"
"2307",24,0,24,17,0,24,12,8,1,2,1,8,206,206,134,72,24,24,56,67,134,107,27,72,27,264,110,154,21,26,147,70,"1000-237"
"2308",17,17,0,17,9,8,9,0,4,4,0,0,17,17,13,4,5,13,10,1,13,5,8,10,6,36,18,18,3,5,24,4,"1900-311"
"2309",15,15,0,15,7,8,0,15,0,0,0,1,15,15,10,5,4,7,8,0,10,5,5,7,4,23,12,11,5,0,15,3,"1900-311"
"2310",11,6,5,11,7,4,9,0,1,1,0,2,36,36,27,9,1,2,5,21,27,12,15,17,10,73,36,37,11,11,41,10,"1900-278"
"2311",17,1,15,10,1,16,0,16,1,0,0,0,164,162,125,37,22,10,55,57,125,80,45,62,37,284,112,172,37,33,140,74,"1900-036"
"2312",28,0,28,27,0,28,0,0,28,0,0,1,279,279,248,31,194,5,3,240,248,146,102,176,97,621,284,337,101,93,299,128,"1950-363"
"2313",20,3,17,19,3,17,1,14,5,0,0,11,120,120,82,38,7,2,20,55,82,68,14,35,7,144,63,81,6,9,67,62,"1600-069"
"2314",4,0,3,4,1,3,1,0,3,0,0,0,41,40,30,10,4,30,26,0,30,19,11,25,7,92,45,47,4,7,69,12,"1600-075"
"2315",6,0,6,4,0,6,0,0,6,0,0,0,120,120,96,24,28,90,72,16,96,63,33,55,30,207,101,106,35,12,124,36,"1500-438"
"2316",25,0,25,25,0,25,0,25,0,0,0,25,238,238,212,26,14,8,163,33,212,143,69,157,47,487,238,249,45,34,227,181,"1600-168"
"2317",22,4,18,13,7,15,15,6,1,0,0,4,91,91,50,41,8,13,32,12,50,38,12,33,11,108,56,52,9,13,71,15,"1100-178"
"2318",30,4,26,28,4,26,22,4,1,2,1,7,180,180,144,36,32,41,75,59,144,100,44,83,40,324,144,180,49,38,169,68,"1200-662"
"2319",9,3,6,4,6,3,6,0,0,2,1,5,48,48,34,14,15,23,20,10,34,23,11,21,9,75,32,43,12,4,39,20,"1249-280"
"2320",6,6,0,6,6,0,6,0,0,0,0,3,12,12,10,2,2,4,9,1,10,7,3,4,1,17,9,8,0,1,8,8,"1300-052"
"2321",37,9,28,30,5,32,27,4,2,3,1,10,199,199,146,53,13,7,50,86,146,105,41,75,38,303,140,163,51,26,160,66,"1200-662"
"2322",29,10,18,28,7,22,12,14,0,0,3,17,126,125,102,23,20,18,48,47,102,72,30,52,29,228,101,127,45,21,117,45,"1350-230"
"2323",15,2,13,10,1,14,3,10,1,1,0,3,109,109,77,32,9,6,22,50,77,65,12,29,5,135,58,77,8,0,94,33,"1150-109"
"2324",3,1,2,2,0,3,2,1,0,0,0,0,32,32,22,10,14,0,14,6,22,17,5,8,3,37,14,23,2,1,24,10,"1150-030"
"2325",35,2,33,35,3,32,9,20,4,2,0,5,235,235,193,42,32,67,108,76,193,132,61,104,57,399,175,224,47,39,221,92,"1900-040"
"2326",41,0,41,35,0,41,32,7,0,2,0,3,375,375,288,87,55,38,162,117,288,195,93,158,77,608,273,335,72,42,347,147,"1900-048"
"2327",43,8,35,41,7,36,0,39,3,1,0,8,283,283,195,88,12,31,97,79,195,142,53,112,41,396,181,215,37,38,210,111,"1070-178"
"2328",25,0,24,15,0,25,0,23,0,2,0,8,199,198,114,84,21,27,52,52,114,85,29,48,21,245,131,114,22,24,161,38,"1150-216"
"2329",9,3,4,6,1,8,1,7,1,0,0,3,38,37,25,12,0,0,6,14,26,18,8,18,8,60,29,31,8,7,35,10,"1150-083"
"2330",12,1,11,10,0,12,10,0,2,0,0,1,87,87,67,20,11,5,30,32,67,48,19,40,15,151,74,77,12,14,90,35,"1150-191"
"2331",28,13,15,28,19,9,28,0,0,0,0,21,107,107,80,27,6,0,19,56,80,53,27,50,29,183,95,88,32,13,109,29,"1900-040"
"2332",3,3,0,3,3,0,2,0,0,0,1,2,4,4,1,3,0,0,0,1,1,1,0,0,0,1,1,0,0,0,0,1,"1900-439"
"2333",0,0,0,0,0,0,0,0,0,0,0,0,0,0,0,0,0,0,0,0,0,0,0,0,0,0,0,0,0,0,0,0,"1250-162"
"2334",0,0,0,0,0,0,0,0,0,0,0,0,0,0,0,0,0,0,0,0,0,0,0,0,0,0,0,0,0,0,0,0,"1099-039"
"2335",59,15,44,57,15,44,39,18,0,0,2,41,439,439,334,105,32,25,122,191,334,234,100,193,96,721,342,379,93,64,433,131,"1170-307"
"2336",3,0,3,3,0,3,1,2,0,0,0,0,24,24,20,4,1,0,8,9,20,11,9,10,7,52,20,32,7,14,27,4,"1170-173"
"2337",38,1,37,37,1,37,34,4,0,0,0,12,230,230,181,49,6,3,72,92,181,132,49,94,45,357,160,197,43,31,213,70,"1900-104"
"2338",65,44,20,63,46,19,1,63,0,1,0,23,195,194,148,46,11,9,49,88,148,107,41,84,45,346,150,196,48,30,167,101,"1070-221"
"2339",16,2,14,10,0,16,13,2,1,0,0,2,104,104,74,30,2,17,31,38,74,50,24,43,18,180,89,91,15,20,115,30,"1150-083"
"2340",13,1,11,8,0,13,0,12,1,0,0,7,77,76,44,32,1,2,25,15,44,28,16,27,14,109,45,64,18,19,52,20,"1150-217"
"2341",36,0,36,34,1,35,35,1,0,0,0,10,216,216,162,54,8,2,72,75,162,117,45,95,43,337,154,183,40,38,176,83,"1900-028"
"2342",26,5,21,21,11,15,12,14,0,0,0,14,295,295,202,93,83,117,99,85,202,138,64,124,67,446,201,245,69,48,213,116,"1070-072"
"2343",31,0,31,27,0,31,6,25,0,0,0,9,226,226,168,58,12,6,77,81,168,117,51,102,38,349,161,188,33,26,203,87,"1900-104"
"2344",11,0,11,11,0,11,0,0,11,0,0,9,239,239,205,34,99,7,4,197,205,127,78,155,83,520,246,274,90,75,253,102,"1350-097"
"2345",9,2,6,8,5,4,1,8,0,0,0,5,33,32,8,24,0,0,1,7,9,9,0,2,0,14,7,7,0,0,6,8,"1169-060"
"2346",0,0,0,0,0,0,0,0,0,0,0,0,0,0,0,0,0,0,0,0,0,0,0,0,0,0,0,0,0,0,0,0,"1350-322"
"2347",14,6,8,10,4,10,12,0,0,2,0,5,39,39,15,24,2,2,6,9,15,13,2,8,3,28,17,11,4,1,15,8,"1250-184"
"2348",13,1,12,9,1,12,8,5,0,0,0,7,76,76,54,22,0,0,16,35,54,41,13,24,9,102,47,55,12,7,61,22,"1100-116"
"2349",2,0,2,2,0,2,0,0,2,0,0,1,41,41,37,4,17,1,32,2,37,25,12,27,16,79,33,46,13,5,47,14,"1400-406"
"2350",4,3,1,4,2,2,0,1,1,2,0,1,16,16,12,4,4,0,12,0,12,9,3,9,2,24,11,13,0,3,11,10,"1400-406"
"2351",31,15,16,27,11,20,30,0,0,1,0,15,126,126,65,61,11,8,16,46,65,52,13,24,9,122,70,52,6,16,75,25,"1250-083"
"2352",37,6,31,24,5,32,20,4,7,5,1,14,169,169,103,66,3,1,21,76,103,77,26,60,25,216,105,111,22,14,134,46,"1100-289"
"2353",0,0,0,0,0,0,0,0,0,0,0,0,0,0,0,0,0,0,0,0,0,0,0,0,0,0,0,0,0,0,0,0,"1250-187"
"2354",17,4,13,14,4,13,15,1,0,0,1,0,64,64,37,27,2,2,16,18,37,29,8,20,6,73,41,32,3,6,39,25,"1200-296"
"2355",55,42,13,55,46,9,3,51,1,0,0,54,113,113,74,39,16,1,9,61,74,56,18,36,17,145,64,81,25,12,79,29,"1350-297"
"2356",47,25,22,41,23,24,44,2,0,1,0,30,185,185,105,80,5,5,40,59,105,81,24,53,20,199,103,96,17,16,111,55,"1100-495"
"2357",31,9,21,26,8,23,21,5,1,0,4,18,215,214,148,66,34,46,81,52,148,86,62,97,60,379,176,203,68,40,194,77,"1250-246"
"2358",8,1,7,4,0,8,8,0,0,0,0,5,50,50,38,12,1,0,11,22,38,28,10,20,10,75,35,40,9,5,51,10,"1200-423"
"2359",53,17,36,37,17,36,45,4,1,2,1,25,198,198,129,69,10,2,14,109,129,85,44,60,31,313,187,126,33,31,188,61,"1100-335"
"2360",22,0,22,16,0,22,21,1,0,0,0,7,108,108,72,36,4,0,9,61,72,50,22,36,14,160,74,86,12,20,102,26,"1150-306"
"2361",6,6,0,6,6,0,0,4,2,0,0,1,6,6,5,1,1,1,4,1,5,2,3,2,2,14,7,7,3,5,6,0,"1400-406"
"2362",15,15,0,15,13,2,0,14,0,1,0,1,15,15,13,2,3,10,11,1,13,5,8,9,9,38,21,17,9,9,18,2,"1400-406"
"2363",6,2,4,5,0,6,4,1,0,1,0,3,27,27,10,17,3,4,4,6,10,7,3,8,2,24,12,12,4,1,13,6,"1250-114"
"2364",9,0,9,5,0,9,0,0,4,5,0,4,275,275,201,74,199,201,135,55,201,114,87,141,91,515,253,262,122,50,299,44,"1990-601"
"2365",5,0,5,5,0,5,0,0,0,5,0,4,43,43,38,5,36,38,30,5,38,20,18,28,17,102,54,48,23,11,64,4,"1990-024"
"2366",14,1,13,13,1,13,5,9,0,0,0,2,147,147,119,28,8,3,48,63,119,100,19,56,21,215,95,120,22,14,106,73,"1350-075"
"2367",0,0,0,0,0,0,0,0,0,0,0,0,0,0,0,0,0,0,0,0,0,0,0,0,0,0,0,0,0,0,0,0,"1350-075"
"2368",21,0,21,18,0,21,2,19,0,0,0,20,222,222,168,54,12,18,70,81,168,117,51,89,43,354,159,195,52,31,163,108,"1350-261"
"2369",15,1,14,8,0,15,11,1,0,1,2,10,94,94,49,45,4,8,13,34,49,45,4,21,5,78,38,40,4,3,53,18,"1200-192"
"2370",26,0,26,23,2,24,18,5,2,0,1,21,234,234,170,64,50,31,77,82,170,118,52,91,54,366,170,196,68,35,180,83,"1350-126"
"2371",21,2,19,19,3,18,5,10,4,0,2,4,109,109,74,35,5,5,43,28,74,56,18,37,19,143,75,68,19,14,80,30,"1070-069"
"2372",8,1,7,8,1,7,1,7,0,0,0,4,59,59,40,19,0,0,28,6,40,27,13,20,13,79,37,42,12,6,46,15,"1070-070"
"2373",20,1,19,18,1,19,6,14,0,0,0,4,140,140,113,27,8,0,46,60,113,87,26,60,28,223,105,118,29,13,133,48,"1170-139"
"2374",69,63,6,69,69,0,62,7,0,0,0,69,98,98,64,34,10,5,0,64,64,48,16,38,18,124,59,65,13,15,58,38,"1900"
"2375",21,3,17,16,0,21,7,9,3,0,2,10,156,155,108,47,16,24,48,57,109,71,38,63,29,253,133,120,31,20,156,46,"1150-007"
"2376",31,10,21,31,27,4,28,3,0,0,0,29,113,113,65,48,2,0,13,48,65,48,17,32,15,120,53,67,13,10,64,33,"1900"
"2377",4,0,4,3,0,4,0,3,0,1,0,3,41,41,29,12,8,7,17,9,29,24,5,10,4,49,24,25,4,2,33,10,"1050-115"
"2378",1,0,0,1,0,1,0,0,1,0,0,0,1,0,0,0,0,0,0,0,0,0,0,0,0,64,12,52,0,0,0,64,"1959-007"
"2379",7,0,7,7,0,7,0,0,7,0,0,0,131,131,108,23,32,108,79,20,108,62,46,74,47,269,142,127,44,38,159,28,"1600-054"
"2380",16,0,16,15,0,16,0,10,6,0,0,5,140,140,110,30,1,5,86,16,110,60,50,80,38,273,137,136,38,19,153,63,"1800-999"
"2381",11,0,11,9,0,11,0,11,0,0,0,0,161,161,129,32,61,2,0,123,129,95,34,76,37,265,114,151,43,23,110,89,"1700-111"
"2382",0,0,0,0,0,0,0,0,0,0,0,0,0,0,0,0,0,0,0,0,0,0,0,0,0,0,0,0,0,0,0,0,"1600-209"
"2383",29,10,19,22,5,24,26,2,1,0,0,18,89,89,68,21,4,0,15,50,68,38,30,46,24,195,119,76,20,22,129,24,"1100-335"
"2384",8,0,8,7,0,8,1,7,0,0,0,5,51,51,39,12,1,0,27,12,39,33,6,18,6,69,29,40,9,2,37,21,"1900-462"
"2385",10,0,10,4,0,10,10,0,0,0,0,5,42,42,16,26,0,0,4,11,16,13,3,8,4,27,13,14,2,3,16,6,"1200-073"
"2386",4,1,3,1,0,4,1,3,0,0,0,2,20,20,12,8,5,0,5,7,12,8,4,7,4,32,23,9,5,2,25,0,"1100-524"
"2387",27,9,18,24,9,18,16,6,2,0,3,4,122,122,93,29,13,36,40,47,93,51,42,67,39,254,127,127,58,24,137,35,"1249-093"
"2388",19,5,14,12,1,18,16,2,1,0,0,6,69,69,36,33,2,3,12,24,36,28,8,16,5,69,37,32,7,4,31,27,"1200-085"
"2389",28,7,21,22,1,27,20,3,3,0,2,10,114,114,85,29,10,8,25,54,85,65,20,45,24,171,75,96,36,14,83,38,"1200-701"
"2390",18,18,0,18,4,14,1,13,3,1,0,2,18,18,15,3,1,3,13,1,15,4,11,14,8,48,27,21,12,3,24,9,"1400-406"
"2391",7,0,7,4,0,7,7,0,0,0,0,3,55,55,36,19,4,0,5,26,36,27,9,14,8,90,59,31,11,7,59,13,"1150-199"
"2392",29,3,26,21,3,26,16,8,0,2,3,16,148,148,83,65,5,9,26,52,83,65,18,33,16,157,80,77,11,21,86,39,"1250-217"
"2393",12,4,8,7,5,7,11,1,0,0,0,5,41,41,17,24,2,1,7,9,17,14,3,6,3,31,16,15,5,2,15,9,"1200-099"
"2394",4,1,3,2,0,4,3,0,0,1,0,2,8,8,6,2,1,2,4,2,6,5,1,2,0,9,4,5,0,0,5,4,"1250-127"
"2395",28,4,24,24,8,20,0,25,0,0,3,19,151,151,128,23,2,0,45,76,128,103,25,70,29,239,96,143,23,20,139,57,"1350-097"
"2396",21,20,1,20,1,20,0,15,5,1,0,11,24,24,19,5,2,13,10,5,19,11,8,13,10,45,20,25,5,9,22,9,"1099-035"
"2397",27,17,10,27,24,3,26,1,0,0,0,27,64,64,35,29,1,2,2,32,35,27,8,21,7,70,38,32,5,10,33,22,"1900-194"
"2398",27,0,27,22,0,27,11,12,2,2,0,1,283,283,214,69,38,27,108,93,214,150,64,101,54,437,216,221,48,51,254,84,"1150-192"
"2399",70,58,12,69,56,14,2,62,4,2,0,7,264,264,201,63,23,19,111,73,201,141,60,116,52,432,179,253,45,46,205,136,"1170-230"
"2400",14,0,14,14,0,14,0,0,0,14,0,0,180,180,158,22,151,158,135,15,158,65,93,128,96,445,216,229,104,56,246,39,"1750-441"
"2401",35,18,17,33,24,11,0,25,10,0,0,30,113,113,96,17,11,7,14,73,96,66,30,67,31,212,97,115,27,24,102,59,"1600-546"
"2402",5,0,5,5,0,5,0,0,0,5,0,0,148,148,132,16,118,132,98,23,132,69,63,85,62,327,165,162,71,40,205,11,"1750-429"
"2403",28,0,28,24,0,28,0,28,0,0,0,18,565,565,407,158,47,8,185,197,407,294,113,240,100,843,376,467,91,78,459,215,"1900-339"
"2404",6,0,6,6,0,6,0,6,0,0,0,2,54,54,42,12,5,0,24,15,42,35,7,19,5,75,32,43,2,8,38,27,"1900-194"
"2405",56,52,4,56,55,1,3,53,0,0,0,48,86,86,64,22,7,1,4,59,64,46,18,37,20,135,68,67,22,18,69,26,"1099-035"
"2406",26,3,23,25,4,22,4,21,0,1,0,5,170,170,132,38,15,16,44,83,132,87,45,77,35,338,177,161,52,18,213,55,"1170-317"
"2407",12,1,10,9,1,11,4,8,0,0,0,1,98,97,70,27,6,7,42,22,71,55,16,36,16,157,64,93,17,9,77,54,"1150-002"
"2408",32,2,30,24,1,31,20,11,1,0,0,4,303,303,234,69,50,63,100,113,234,164,70,124,65,504,244,260,74,51,280,99,"1169-045"
"2409",16,9,7,15,10,6,9,7,0,0,0,7,46,46,34,12,2,0,17,15,34,23,11,22,7,73,29,44,7,4,42,20,"1070-073"
"2410",4,3,0,4,3,1,1,2,0,1,0,4,4,3,2,1,1,2,0,2,2,1,1,2,0,24,11,13,19,0,4,1,"1500-462"
"2411",18,0,18,13,0,18,0,17,0,1,0,0,187,187,142,45,11,4,55,69,142,86,56,84,53,330,156,174,65,30,170,65,"1000-266"
"2412",18,0,18,15,0,18,0,14,2,1,1,6,120,120,76,44,15,17,39,29,76,67,9,30,9,123,56,67,3,12,78,30,"1600-093"
"2413",29,1,28,25,0,29,17,7,4,1,0,12,302,302,232,70,58,126,125,90,232,152,80,146,68,530,260,270,53,73,301,103,"1649-021"
"2414",21,6,15,14,7,14,2,1,4,14,0,3,158,158,111,47,63,80,47,56,111,58,53,80,58,306,164,142,74,47,162,23,"1500-618"
"2415",22,0,22,19,0,22,1,21,0,0,0,0,177,177,125,52,1,4,44,72,125,96,29,62,27,235,92,143,31,8,142,54,"1500-133"
"2416",5,0,5,2,0,5,0,0,0,5,0,1,207,207,155,52,145,154,89,36,155,114,41,74,40,298,137,161,43,17,202,36,"1750-170"
"2417",24,0,24,20,0,24,0,24,0,0,0,9,369,369,315,54,107,9,258,37,315,210,105,193,89,691,321,370,92,60,341,198,"1800-081"
"2418",21,21,0,21,1,20,0,0,18,3,0,0,21,21,18,3,9,18,16,0,18,8,10,18,10,57,32,25,7,12,27,11,"1600-645"
"2419",14,0,14,14,0,14,0,0,14,0,0,0,162,162,153,9,31,4,7,142,153,68,85,134,77,465,223,242,82,57,252,74,"1600-003"
"2420",19,0,19,16,0,19,0,19,0,0,0,3,358,358,276,82,79,2,168,79,276,201,75,152,63,572,245,327,58,64,282,168,NA
"2421",21,0,21,19,0,21,0,21,0,0,0,21,208,208,154,54,20,1,111,36,154,105,49,92,41,320,142,178,33,28,163,96,"1500-530"
"2422",9,0,9,6,0,9,0,0,9,0,0,0,142,142,125,17,62,13,104,17,125,72,53,92,48,320,150,170,60,32,138,90,"1600-155"
"2423",7,0,7,6,0,7,0,7,0,0,0,2,102,102,88,14,45,48,52,29,88,65,23,55,20,180,88,92,21,11,80,68,"1500-597"
"2424",29,0,28,26,0,29,0,28,1,0,0,14,357,356,260,96,24,3,180,62,260,182,78,153,62,573,277,296,53,55,308,157,"1500-593"
"2425",4,4,0,4,3,1,3,1,0,0,0,4,5,5,4,1,1,0,2,1,4,2,2,3,2,10,4,6,3,1,4,2,"1900-107"
"2426",28,27,1,28,28,0,16,5,5,2,0,4,31,31,27,4,9,20,21,4,27,22,5,18,4,56,24,32,7,0,30,19,"1070-181"
"2427",5,0,5,0,0,5,5,0,0,0,0,4,9,9,6,3,0,0,4,2,6,5,1,1,1,10,8,2,2,0,7,1,"1100-054"
"2428",6,0,6,6,0,6,0,0,0,6,0,3,153,153,138,15,110,6,4,131,138,72,66,101,64,365,168,197,75,57,163,70,"1300-125"
"2429",15,2,13,15,2,13,7,6,2,0,0,5,84,84,52,32,6,8,30,18,52,25,27,38,23,148,69,79,23,31,73,21,"1200-602"
"2430",12,2,10,7,3,9,12,0,0,0,0,11,37,37,16,21,2,4,6,10,16,13,3,6,2,26,10,16,3,0,11,12,"1200-270"
"2431",36,9,26,30,4,32,23,10,2,1,0,21,175,174,115,59,10,19,58,54,115,84,31,61,31,240,105,135,35,21,129,55,"1200-624"
"2432",25,9,16,24,8,17,11,12,0,1,1,15,125,125,88,37,20,24,33,44,88,73,15,37,18,164,72,92,19,13,103,29,"1350-251"
"2433",15,4,11,12,5,10,14,1,0,0,0,0,66,66,40,26,2,0,17,18,40,28,12,16,9,75,36,39,11,2,44,18,"1200-996"
"2434",20,2,18,12,3,17,20,0,0,0,0,1,58,58,27,31,0,0,10,16,27,22,5,11,5,51,24,27,3,5,32,11,"1200-032"
"2435",5,1,4,3,0,5,3,0,2,0,0,3,19,19,4,15,0,0,0,3,4,2,2,2,0,8,4,4,0,0,7,1,"1100-051"
"2436",17,0,17,17,0,17,0,17,0,0,0,9,182,182,164,18,13,3,51,109,164,69,95,134,64,479,244,235,76,60,232,111,"1300-070"
"2437",20,3,17,11,3,17,20,0,0,0,0,2,67,67,46,21,4,0,6,37,46,39,7,19,7,77,39,38,5,6,47,19,"1100-081"
"2438",20,9,11,13,4,16,20,0,0,0,0,17,48,48,36,12,0,0,2,27,36,24,12,18,10,77,39,38,8,9,43,17,NA
"2439",14,14,0,14,12,2,0,13,0,1,0,2,14,14,12,2,1,10,12,0,12,6,6,10,5,31,16,15,3,4,15,9,"1349-016"
"2440",40,28,12,40,25,15,22,17,1,0,0,14,125,125,108,17,8,18,45,59,108,58,50,84,40,282,129,153,35,35,139,73,"1300-070"
"2441",20,4,16,9,6,14,17,1,2,0,0,14,60,60,32,28,1,0,6,24,32,25,7,14,6,58,31,27,5,6,29,18,"1100-274"
"2442",40,31,9,39,38,2,35,5,0,0,0,25,84,84,37,47,1,0,6,28,37,28,9,17,6,67,30,37,2,8,38,19,"1350-188"
"2443",6,1,5,5,1,5,6,0,0,0,0,0,25,25,10,15,0,1,1,8,10,8,2,4,3,17,8,9,3,1,13,0,"1100-029"
"2444",8,2,6,6,1,7,7,0,1,0,0,7,30,30,24,6,1,0,4,19,24,16,8,8,6,59,44,15,5,3,49,2,"1100-042"
"2445",1,0,0,1,1,0,0,1,0,0,0,0,1,0,0,0,0,0,0,0,0,0,0,0,0,23,3,20,0,0,0,23,"1100-145"
"2446",26,9,17,18,10,16,25,1,0,0,0,7,70,70,46,24,2,0,9,37,46,37,9,22,8,85,45,40,11,10,43,21,"1100-029"
"2447",24,5,19,20,1,23,10,6,3,2,3,3,140,140,107,33,9,53,52,45,107,64,43,70,39,272,137,135,51,29,133,59,"1200-780"
"2448",22,4,17,11,2,20,19,1,2,0,0,18,107,106,72,34,2,0,27,39,72,45,27,51,25,201,106,95,28,27,115,31,"1100-232"
"2449",5,4,1,5,0,5,5,0,0,0,0,3,11,11,7,4,0,0,0,6,7,7,0,0,0,7,5,2,0,0,2,5,"1100-203"
"2450",10,1,9,5,0,10,10,0,0,0,0,5,63,63,43,20,2,2,5,37,43,37,6,16,6,69,35,34,5,5,28,31,"1249-115"
"2451",15,4,11,6,3,12,15,0,0,0,0,5,32,32,19,13,0,0,5,13,19,14,5,6,2,34,12,22,2,6,14,12,"1100-616"
"2452",13,3,10,11,2,11,10,0,1,0,2,5,56,56,23,33,4,3,5,15,23,14,9,10,6,48,24,24,7,3,30,8,"1150-291"
"2453",0,0,0,0,0,0,0,0,0,0,0,0,0,0,0,0,0,0,0,0,0,0,0,0,0,0,0,0,0,0,0,0,"1250-036"
"2454",34,6,28,28,8,26,30,3,0,0,1,24,197,197,158,39,12,1,68,81,158,105,53,73,36,378,205,173,39,41,242,56,"1150-087"
"2455",27,0,25,22,0,27,11,16,0,0,0,2,261,258,210,48,2,3,84,106,210,146,64,112,52,465,225,240,48,33,308,76,"1170-234"
"2456",17,1,16,14,1,16,9,8,0,0,0,11,99,99,78,21,2,0,35,37,78,64,14,41,12,143,59,84,7,10,91,35,"1170-163"
"2457",42,3,39,38,2,40,6,29,6,0,1,14,445,445,344,101,38,112,162,163,344,275,69,159,67,628,272,356,64,53,337,174,"1500-409"
"2458",15,0,15,14,0,15,0,14,1,0,0,0,317,317,271,46,139,161,209,24,271,176,95,177,79,636,278,358,81,69,280,206,"1500-588"
"2459",35,35,0,35,35,0,0,30,5,0,0,5,35,35,26,9,14,18,25,0,26,8,18,21,11,74,35,39,15,5,41,13,"1500-618"
"2460",49,48,0,49,48,1,1,31,16,0,1,46,50,49,6,43,1,1,0,2,6,1,5,7,5,58,23,35,9,5,12,32,"1675-632"
"2461",6,0,6,6,0,6,0,6,0,0,0,0,115,115,97,18,27,2,43,47,97,76,21,53,22,197,91,106,22,15,100,60,"1800-279"
"2462",24,24,0,24,4,20,0,0,24,0,0,0,24,24,22,2,6,22,21,1,22,15,7,15,6,52,22,30,7,5,20,20,"1800-368"
"2463",0,0,0,0,0,0,0,0,0,0,0,0,0,0,0,0,0,0,0,0,0,0,0,0,0,0,0,0,0,0,0,0,"1990-156"
"2464",22,3,19,20,3,19,4,18,0,0,0,2,204,204,166,38,19,19,82,72,166,127,39,100,38,337,149,188,30,30,170,107,"1800-279"
"2465",9,0,9,6,0,9,0,0,0,9,0,1,333,333,280,53,266,279,223,42,280,158,122,187,127,692,347,345,164,63,416,49,"1750-429"
"2466",17,17,0,17,14,3,1,15,1,0,0,4,17,17,13,4,2,11,11,0,13,6,7,13,7,39,21,18,1,11,19,8,"1800-192"
"2467",5,0,5,3,0,5,0,0,0,5,0,0,146,146,128,18,122,127,102,20,128,74,54,89,57,300,142,158,54,33,191,22,"1750-316"
"2468",40,38,2,40,38,2,0,19,21,0,0,35,78,78,39,39,5,4,15,23,39,29,10,25,7,83,37,46,8,6,33,36,"1675-632"
"2469",1,1,0,1,1,0,0,0,0,1,0,0,1,1,1,0,1,1,0,0,1,0,1,3,2,12,4,8,5,1,5,1,"1675-632"
"2470",16,7,9,16,10,6,1,14,1,0,0,8,78,78,58,20,6,4,6,46,58,36,22,41,26,143,63,80,24,23,71,25,"1750-123"
"2471",1,1,0,1,1,0,1,0,0,0,0,0,1,1,1,0,1,1,1,0,1,0,1,3,1,10,4,6,0,1,8,1,"1750-111"
"2472",10,0,10,8,4,6,0,5,0,5,0,5,115,115,103,12,58,57,60,39,103,54,49,72,58,273,123,150,58,41,166,8,"1750-462"
"2473",3,0,3,3,0,3,0,0,0,3,0,0,60,60,58,2,33,0,0,56,58,39,19,38,20,135,58,77,32,16,52,35,"1750-462"
"2474",0,0,0,0,0,0,0,0,0,0,0,0,0,0,0,0,0,0,0,0,0,0,0,0,0,0,0,0,0,0,0,0,"1750-111"
"2475",20,20,0,20,18,2,0,20,0,0,0,2,22,22,21,1,4,18,16,1,21,13,8,17,7,51,27,24,6,4,21,20,"1800-362"
"2476",9,0,8,5,0,9,0,9,0,0,0,3,191,190,142,48,52,126,100,24,142,99,43,84,28,314,134,180,30,25,125,134,NA
"2477",7,0,7,5,0,7,0,0,0,7,0,0,224,224,193,31,168,193,159,24,193,103,90,137,91,481,224,257,92,57,283,49,"1750-105"
"2478",14,0,13,11,0,14,0,2,4,8,0,1,348,347,304,43,275,301,265,21,304,167,137,236,127,836,422,414,125,132,414,165,"1750-151"
"2479",6,0,6,5,0,6,0,0,0,6,0,0,220,220,200,20,182,8,7,184,200,84,116,182,108,612,283,329,98,109,316,89,"1750-416"
"2480",15,0,15,10,0,15,0,0,15,0,0,3,79,79,48,31,38,48,32,14,48,34,14,35,16,109,52,57,19,10,56,24,"1990-011"
"2481",0,0,0,0,0,0,0,0,0,0,0,0,0,0,0,0,0,0,0,0,0,0,0,0,0,0,0,0,0,0,0,0,"1990-265"
"2482",4,4,0,4,4,0,4,0,0,0,0,4,4,4,0,4,0,0,0,0,0,0,0,0,0,0,0,0,0,0,0,0,"1750-416"
"2483",15,0,15,14,0,15,0,15,0,0,0,7,161,161,130,31,7,17,93,25,130,94,36,79,29,266,117,149,26,28,133,79,"1800-329"
"2484",2,0,2,0,0,2,0,0,0,2,0,0,227,227,111,116,109,109,38,64,111,80,31,52,30,217,106,111,33,20,150,14,"1990-156"
"2485",22,22,0,22,18,4,15,6,0,1,0,4,22,22,18,4,3,15,17,0,18,7,11,15,9,54,29,25,14,4,24,12,"1749-077"
"2486",14,3,11,11,4,10,0,13,1,0,0,4,182,182,143,39,36,3,69,59,143,99,44,89,29,309,143,166,31,15,169,94,"1885-031"
"2487",7,7,0,7,4,3,4,1,0,2,0,1,7,7,6,1,1,4,5,1,6,3,3,3,2,13,5,8,2,2,8,1,"1749-077"
"2488",0,0,0,0,0,0,0,0,0,0,0,0,0,0,0,0,0,0,0,0,0,0,0,0,0,0,0,0,0,0,0,0,"1800-362"
"2489",7,0,7,7,0,7,0,0,7,0,0,0,187,187,178,9,96,2,11,157,178,83,95,148,88,524,254,270,99,80,274,71,"1750-184"
"2490",15,7,8,14,7,8,7,8,0,0,0,3,115,115,99,16,36,52,63,26,99,79,20,53,14,185,82,103,5,15,82,83,"1800-279"
"2491",14,5,5,14,6,8,8,0,2,0,4,1,44,40,24,15,17,21,21,3,27,11,16,20,17,128,53,75,23,8,72,25,"1600-546"
"2492",0,0,0,0,0,0,0,0,0,0,0,0,0,0,0,0,0,0,0,0,0,0,0,0,0,0,0,0,0,0,0,0,"1800-111"
"2493",13,0,13,11,0,13,0,13,0,0,0,8,327,327,274,53,77,9,186,74,274,183,91,166,81,604,273,331,64,66,321,153,"1800-245"
"2494",10,5,5,9,6,4,0,0,10,0,0,5,106,106,84,22,31,4,62,16,84,64,20,42,20,168,78,90,24,12,95,37,"1600-625"
"2495",9,0,9,9,0,9,0,9,0,0,0,3,202,202,173,29,112,0,127,30,173,119,54,104,49,363,165,198,43,31,175,114,"1800-119"
"2496",2,0,0,2,1,1,1,0,0,0,1,0,3,0,0,0,0,0,0,0,0,0,0,0,0,33,0,33,0,0,5,28,"1700-284"
"2497",29,29,0,28,29,0,1,26,0,0,2,13,30,30,27,3,16,16,22,1,27,20,7,16,3,60,32,28,2,8,20,30,"1700-322"
"2498",15,12,3,15,9,6,0,15,0,0,0,4,86,86,77,9,29,11,60,14,77,44,33,47,21,188,96,92,19,20,99,50,"1800-119"
"2499",25,25,0,25,25,0,0,24,1,0,0,23,25,25,24,1,11,14,19,3,24,15,9,15,5,55,30,25,4,2,32,17,"1700-079"
"2500",49,49,0,49,37,12,16,24,4,5,0,5,50,50,41,9,4,35,35,4,41,21,20,35,16,110,54,56,15,11,49,35,"1800-281"
"2501",16,0,16,16,0,16,0,0,0,16,0,0,359,359,300,59,231,299,227,52,300,188,112,174,119,670,310,360,135,66,431,38,"1750-204"
"2502",47,47,0,47,43,4,15,27,3,1,1,10,47,47,35,12,7,31,32,1,35,20,15,29,14,83,42,41,11,9,36,27,"1800-281"
"2503",0,0,0,0,0,0,0,0,0,0,0,0,0,0,0,0,0,0,0,0,0,0,0,0,0,0,0,0,0,0,0,0,"1675-632"
"2504",6,0,6,6,0,6,0,0,6,0,0,0,32,32,22,10,22,21,15,4,22,10,12,20,10,68,36,32,19,4,26,19,"1990-134"
"2505",9,0,9,7,0,9,0,0,3,6,0,0,239,239,209,30,192,209,174,31,209,91,118,163,122,585,271,314,152,63,339,31,"1700-474"
"2506",3,1,0,3,3,0,0,2,1,0,0,1,3,1,0,1,0,0,0,0,0,0,0,0,0,29,17,12,0,0,24,5,NA
"2507",17,7,10,17,3,14,11,0,6,0,0,3,70,70,58,12,18,38,42,11,58,33,25,44,27,156,73,83,27,24,74,31,"1600-188"
"2508",28,28,0,28,28,0,8,0,20,0,0,28,30,30,16,14,4,2,10,6,16,10,6,12,6,41,20,21,3,8,16,14,"1600-587"
"2509",9,4,4,9,3,6,2,4,1,1,1,7,32,31,23,8,5,7,6,15,23,17,6,18,9,84,27,57,9,4,26,45,"1600-766"
"2510",10,0,10,10,0,10,0,10,0,0,0,2,83,83,69,14,4,5,54,12,69,45,24,50,19,172,77,95,21,18,88,45,"1750-025"
"2511",2,0,2,2,0,2,0,0,0,2,0,2,54,54,49,5,48,49,40,6,49,19,30,36,30,144,74,70,44,11,82,7,"1990-506"
"2512",48,25,23,48,35,13,24,10,1,13,0,29,262,262,218,44,141,139,131,73,218,109,109,164,110,575,284,291,117,74,320,64,"1750-423"
"2513",7,7,0,7,7,0,0,6,0,1,0,2,7,7,6,1,1,5,6,0,6,4,2,7,2,17,7,10,2,1,4,10,"1750-342"
"2514",0,0,0,0,0,0,0,0,0,0,0,0,0,0,0,0,0,0,0,0,0,0,0,0,0,0,0,0,0,0,0,0,"1800-134"
"2515",13,0,13,12,0,13,0,13,0,0,0,0,107,107,90,17,7,0,46,38,90,65,25,51,23,192,78,114,27,19,85,61,"1750-314"
"2516",11,5,6,8,7,4,0,10,0,0,1,6,39,39,30,9,3,14,12,17,30,21,9,14,8,60,31,29,11,9,28,12,"1800-364"
"2517",24,24,0,24,18,6,0,5,17,2,0,8,25,25,18,7,3,14,16,0,18,9,9,16,8,57,31,26,15,3,30,9,"1800-368"
"2518",56,56,0,56,56,0,2,54,0,0,0,55,56,56,46,10,6,9,0,45,46,30,16,41,14,123,59,64,18,5,75,25,"1500-171"
"2519",25,25,0,25,10,15,0,7,13,2,3,9,25,25,23,2,11,21,22,0,23,11,12,19,10,65,28,37,12,5,30,18,"1800-364"
"2520",0,0,0,0,0,0,0,0,0,0,0,0,0,0,0,0,0,0,0,0,0,0,0,0,0,0,0,0,0,0,0,0,"1990-265"
"2521",2,0,2,2,2,0,0,0,0,0,2,0,20,20,20,0,13,1,1,19,20,10,10,18,8,56,26,30,7,5,34,10,"1600-647"
"2522",12,0,12,10,0,12,0,12,0,0,0,0,345,345,290,55,76,3,30,253,290,203,87,203,77,654,300,354,81,64,284,225,"1800-046"
"2523",0,0,0,0,0,0,0,0,0,0,0,0,0,0,0,0,0,0,0,0,0,0,0,0,0,0,0,0,0,0,0,0,"1998-030"
"2524",18,18,0,18,14,4,0,1,17,0,0,4,18,18,14,4,6,14,12,1,14,4,10,14,7,46,21,25,4,5,26,11,"1800-192"
"2525",0,0,0,0,0,0,0,0,0,0,0,0,0,0,0,0,0,0,0,0,0,0,0,0,0,0,0,0,0,0,0,0,"1990-084"
"2526",19,0,19,16,0,19,0,17,0,2,0,0,347,347,264,83,59,43,148,101,264,194,70,138,58,539,231,308,61,40,256,182,"1600-489"
"2527",14,12,1,14,14,0,0,14,0,0,0,10,20,19,10,9,2,5,4,5,10,4,6,8,4,42,16,26,1,6,15,20,"1800-364"
"2528",4,0,3,2,0,4,0,0,0,4,0,0,137,136,120,16,97,120,93,23,120,63,57,90,59,316,158,158,57,47,181,31,NA
"2529",33,33,0,33,33,0,0,32,1,0,0,12,33,33,30,3,2,28,29,0,30,20,10,26,9,77,34,43,6,7,26,38,"1750-342"
"2530",11,11,0,11,11,0,0,11,0,0,0,11,12,12,11,1,3,9,9,0,11,7,4,11,1,30,14,16,1,0,18,11,"1750-342"
"2531",20,3,16,18,2,18,0,16,1,0,3,3,429,428,339,89,77,155,238,68,339,247,92,207,86,711,353,358,89,64,350,208,"1600-038"
"2532",5,5,0,5,5,0,1,3,1,0,0,3,5,5,5,0,1,1,0,4,5,3,2,4,3,14,7,7,3,2,7,2,"1750-025"
"2533",3,0,3,1,0,3,0,0,3,0,0,3,58,58,57,1,45,6,3,53,57,21,36,51,34,183,92,91,30,31,103,19,"1750-342"
"2534",3,0,3,2,0,3,0,0,3,0,0,2,54,54,52,2,41,1,11,38,52,22,30,46,31,174,75,99,41,29,80,24,"1750-339"
"2535",4,4,0,4,4,0,1,3,0,0,0,3,6,6,3,3,2,2,1,1,3,2,1,2,0,6,3,3,0,0,2,4,"1750-025"
"2536",20,6,14,19,6,14,3,3,14,0,0,10,357,357,330,27,163,13,37,274,330,166,164,259,150,917,433,484,151,137,482,147,"1750-184"
"2537",24,24,0,24,0,24,0,0,24,0,0,0,24,24,23,1,1,23,18,3,23,12,11,22,13,68,32,36,10,13,32,13,"1990-506"
"2538",11,0,11,11,0,11,0,0,1,10,0,0,121,121,105,16,80,105,97,5,105,53,52,78,41,256,117,139,23,36,163,34,"1750-200"
"2539",34,34,0,34,0,34,0,0,18,16,0,0,34,34,32,2,2,31,25,7,32,9,23,30,21,107,48,59,25,19,54,9,"1990-392"
"2540",5,0,5,4,0,5,0,0,5,0,0,0,65,65,58,7,52,58,53,3,58,32,26,50,26,153,71,82,24,21,78,30,"1990-370"
"2541",11,5,6,11,5,6,0,0,11,0,0,0,83,83,62,21,17,54,45,14,62,44,18,43,14,137,69,68,11,9,81,36,"1750-200"
"2542",21,21,0,21,13,8,10,4,2,5,0,5,21,21,18,3,5,17,14,2,18,9,9,19,8,52,28,24,9,3,23,17,"1800-362"
"2543",42,41,1,42,42,0,35,5,1,0,1,10,46,46,39,7,9,1,5,33,39,29,10,21,10,84,42,42,10,10,43,21,"1750-200"
"2544",0,0,0,0,0,0,0,0,0,0,0,0,0,0,0,0,0,0,0,0,0,0,0,0,0,0,0,0,0,0,0,0,"1800-190"
"2545",8,0,8,4,0,8,0,8,0,0,0,1,181,181,126,55,43,114,84,26,126,100,26,70,19,245,102,143,18,21,109,97,"1750-144"
"2546",4,0,4,3,0,4,0,0,0,4,0,0,202,202,170,32,145,170,137,23,170,91,79,120,87,422,195,227,85,52,260,25,"1740-441"
"2547",9,0,9,9,0,9,0,0,9,0,0,0,72,72,64,8,47,64,54,3,64,39,25,52,23,167,90,77,19,25,70,53,"1600-483"
"2548",5,0,5,5,0,5,0,0,0,5,0,0,113,113,82,31,67,82,60,17,82,41,41,53,40,206,94,112,47,19,130,10,"1750-204"
"2549",29,1,28,27,1,28,1,25,3,0,0,7,282,282,244,38,63,86,190,37,244,187,57,151,43,493,223,270,38,35,234,186,"1800-177"
"2550",12,7,5,12,8,4,7,0,4,0,1,5,46,46,44,2,30,37,30,13,44,22,22,32,17,122,59,63,24,14,58,26,"1600-483"
"2551",22,0,22,20,0,22,0,20,2,0,0,11,348,348,272,76,91,26,164,86,272,190,82,164,60,571,246,325,55,46,297,173,"1800-329"
"2552",18,18,0,18,8,10,2,11,2,2,1,3,18,18,14,4,4,13,13,1,14,7,7,11,7,40,21,19,2,10,19,9,"1800-281"
"2553",18,0,18,10,0,18,0,0,0,18,0,4,313,313,235,78,209,235,162,61,235,158,77,142,79,530,253,277,95,55,327,53,"1990-305"
"2554",6,5,1,4,5,1,3,3,0,0,0,3,9,9,5,4,0,0,0,5,5,5,0,2,0,8,3,5,0,1,6,1,"1750-293"
"2555",18,0,18,18,0,18,0,0,18,0,0,11,155,155,136,19,16,59,116,12,136,83,53,107,37,319,156,163,23,29,192,75,"1800-177"
"2556",35,11,24,34,25,10,2,29,4,0,0,20,132,132,100,32,15,16,12,81,100,67,33,68,29,221,104,117,31,22,120,48,"1600-516"
"2557",16,0,16,15,0,16,0,0,1,15,0,7,376,376,309,67,256,148,101,193,309,169,140,215,139,809,373,436,134,114,476,85,"1750-204"
"2558",0,0,0,0,0,0,0,0,0,0,0,0,0,0,0,0,0,0,0,0,0,0,0,0,0,0,0,0,0,0,0,0,"1675-632"
"2559",9,0,9,8,0,9,0,0,0,9,0,0,105,105,64,41,58,64,39,17,64,46,18,48,17,138,65,73,21,4,70,43,NA
"2560",58,58,0,58,34,24,34,7,7,7,3,13,58,58,47,11,13,45,44,1,47,19,28,42,22,140,66,74,22,19,69,30,"1800-362"
"2561",12,7,5,11,3,9,9,2,0,1,0,4,29,29,23,6,3,8,6,12,23,15,8,18,7,57,26,31,9,3,36,9,"1800-281"
"2562",8,0,8,6,0,8,0,8,0,0,0,0,113,113,90,23,13,2,42,42,90,64,26,56,27,196,87,109,36,16,90,54,"1750-186"
"2563",6,0,6,4,0,6,0,6,0,0,0,6,136,136,109,27,66,5,79,18,109,92,17,53,15,190,81,109,12,12,86,80,"1750-011"
"2564",39,10,29,36,10,29,0,39,0,0,0,20,239,239,189,50,5,11,154,20,189,125,64,132,56,439,204,235,55,37,255,92,NA
"2565",24,24,0,23,24,0,18,1,5,0,0,18,27,27,16,11,2,4,6,9,16,13,3,8,5,28,14,14,3,4,11,10,"1600-553"
"2566",27,8,18,26,9,18,0,25,2,0,0,5,227,226,174,52,22,8,88,74,174,118,56,105,47,398,180,218,54,37,209,98,"1800-088"
"2567",16,0,16,16,0,16,0,0,0,16,0,0,188,188,168,20,68,168,138,19,168,92,76,108,72,398,203,195,73,43,245,37,"1500-210"
"2568",34,21,13,32,23,11,20,1,13,0,0,13,209,209,175,34,74,127,141,18,175,120,55,122,47,396,180,216,41,42,184,129,"1600-766"
"2569",6,0,6,5,0,6,0,0,5,1,0,0,213,213,188,25,162,187,161,15,188,97,91,154,84,497,247,250,58,81,259,99,"1600-453"
"2570",12,6,6,11,4,8,0,0,11,1,0,2,70,70,59,11,37,41,44,11,59,45,14,36,8,124,55,69,16,4,57,47,"1600-576"
"2571",24,0,23,24,0,24,0,22,2,0,0,0,222,221,152,69,4,3,69,75,152,109,43,91,32,314,150,164,26,23,180,85,"1700-046"
"2572",11,0,11,10,0,11,0,0,11,0,0,0,161,161,145,16,81,129,115,16,145,88,57,110,56,352,162,190,54,44,171,83,"1600-451"
"2573",6,0,6,6,0,6,0,6,0,0,0,3,72,72,69,3,5,1,33,28,69,38,31,53,24,179,84,95,30,18,85,46,"1800-245"
"2574",16,16,0,16,14,2,0,16,0,0,0,2,16,16,11,5,4,11,10,0,11,5,6,6,2,31,16,15,5,2,16,8,"1700-003"
"2575",7,0,7,4,0,7,0,7,0,0,0,0,140,140,115,25,96,1,80,27,115,75,40,79,27,281,135,146,17,34,137,93,"1800-079"
"2576",8,0,8,8,0,8,0,2,6,0,0,0,122,122,104,18,77,62,81,13,104,74,30,67,22,213,102,111,20,13,90,90,"1600-634"
"2577",0,0,0,0,0,0,0,0,0,0,0,0,0,0,0,0,0,0,0,0,0,0,0,0,0,0,0,0,0,0,0,0,"1950-037"
"2578",46,7,34,39,9,37,12,21,12,1,0,39,422,417,279,137,81,81,75,184,281,190,91,175,90,843,311,532,132,93,336,282,"1700-238"
"2579",14,0,14,14,0,14,0,0,1,13,0,0,170,170,157,13,137,154,144,8,157,76,81,124,75,421,197,224,50,81,218,72,"1600-236"
"2580",16,1,15,15,1,15,0,15,1,0,0,8,236,236,186,50,54,15,130,39,186,132,54,94,44,374,172,202,49,25,192,108,"1700-322"
"2581",14,0,14,12,0,14,0,14,0,0,0,1,207,207,174,33,108,0,130,34,174,115,59,107,46,404,180,224,48,47,192,117,"1800-077"
"2582",7,0,7,7,0,7,0,0,7,0,0,1,199,199,167,32,131,53,137,19,167,122,45,107,37,353,160,193,41,21,167,124,"1601-801"
"2583",2,0,2,2,0,2,0,2,0,0,0,0,57,57,49,8,34,0,36,10,49,35,14,30,9,101,47,54,8,5,51,37,"1800-328"
"2584",15,0,15,15,5,10,0,0,15,0,0,1,199,199,171,28,53,166,130,29,171,108,63,109,57,391,174,217,54,47,226,64,"1600-626"
"2585",10,0,10,9,0,10,0,0,0,10,0,0,114,114,94,20,87,94,76,10,94,41,53,78,55,264,125,139,64,31,140,29,"1990-074"
"2586",31,13,18,31,10,21,1,1,20,7,2,0,160,160,124,36,42,61,69,41,124,101,23,64,19,234,100,134,19,20,129,66,"1600-236"
"2587",8,0,8,6,0,8,0,0,0,8,0,0,87,87,73,14,72,73,64,5,73,37,36,57,32,191,99,92,35,22,105,29,"1990-221"
"2588",15,8,7,15,11,4,2,1,2,1,9,1,44,44,39,5,9,26,25,10,39,16,23,34,25,116,50,66,27,19,57,13,"1600-587"
"2589",23,21,2,22,23,0,21,0,1,1,0,11,30,30,19,11,7,2,12,6,19,10,9,13,7,46,26,20,4,8,24,10,"1600-532"
"2590",8,0,8,8,0,8,0,0,8,0,0,2,64,64,50,14,1,4,37,7,50,26,24,36,19,131,64,67,15,22,71,23,"1500-450"
"2591",5,0,5,5,0,5,0,0,0,5,0,0,146,146,128,18,112,128,96,24,128,72,56,89,54,327,154,173,51,53,179,44,"1600-454"
"2592",8,0,8,8,0,8,0,0,8,0,0,0,127,127,105,22,62,104,90,5,105,64,41,67,33,238,101,137,31,23,123,61,"1600-618"
"2593",9,0,9,8,0,9,0,0,0,9,0,0,173,173,140,33,117,139,118,16,140,81,59,103,51,350,157,193,49,45,202,54,"1600-451"
"2594",1,0,0,1,1,0,1,0,0,0,0,1,2,0,0,0,0,0,0,0,0,0,0,0,0,28,0,28,5,23,0,0,"1600-451"
"2595",11,0,11,6,0,11,0,11,0,0,0,2,73,73,69,4,1,2,60,1,69,54,15,42,8,134,57,77,9,4,56,65,"1600-553"
"2596",19,0,19,13,0,19,0,18,1,0,0,13,265,265,199,66,88,6,163,26,199,145,54,115,44,411,182,229,38,30,198,145,"1800-000"
"2597",6,0,6,6,0,6,0,6,0,0,0,6,72,72,62,10,2,1,32,23,62,36,26,48,16,150,75,75,22,12,84,32,"1800-056"
"2598",16,0,16,16,0,16,0,16,0,0,0,9,128,128,104,24,1,1,52,40,104,63,41,69,37,254,129,125,32,26,151,45,"1800-245"
"2599",15,0,15,14,0,15,0,0,15,0,0,3,125,125,85,40,1,4,49,25,85,50,35,52,27,198,83,115,25,16,115,42,"1500-450"
"2600",17,10,7,15,11,6,11,6,0,0,0,11,306,306,238,68,114,230,192,20,238,165,73,150,60,517,238,279,92,18,232,175,"1500-430"
"2601",3,3,0,3,3,0,1,2,0,0,0,3,4,4,4,0,0,1,2,2,4,4,0,0,0,4,2,2,0,0,0,4,"1600-155"
"2602",4,0,4,2,0,4,0,4,0,0,0,0,101,101,82,19,57,1,72,1,82,60,22,49,15,167,69,98,17,5,73,72,"1800-088"
"2603",23,0,23,22,0,23,0,22,0,0,1,19,413,413,329,84,64,21,198,102,329,250,79,171,71,629,264,365,61,46,289,233,"1600-413"
"2604",3,0,3,3,0,3,0,0,3,0,0,0,83,83,63,20,59,61,54,5,63,40,23,49,20,153,75,78,15,22,68,48,"1600-477"
"2605",0,0,0,0,0,0,0,0,0,0,0,0,2,2,0,0,0,0,0,0,2,0,2,5,1,14,7,7,1,1,12,0,"1959-007"
"2606",7,0,7,6,0,7,0,1,1,5,0,1,256,256,219,37,183,73,133,76,219,139,80,156,73,510,230,280,52,68,289,101,"1950-239"
"2607",16,0,16,16,0,16,0,0,0,16,0,1,256,256,231,25,128,231,208,10,231,110,121,185,124,624,315,309,102,92,372,58,"1500-210"
"2608",21,15,6,21,11,10,0,0,6,15,0,3,86,86,58,28,44,17,45,12,58,40,18,32,20,120,54,66,17,16,67,20,"1600-626"
"2609",5,0,5,5,0,5,0,5,0,0,0,0,66,66,55,11,23,2,44,5,55,38,17,41,12,130,54,76,9,16,57,48,"1800-000"
"2610",0,0,0,0,0,0,0,0,0,0,0,0,0,0,0,0,0,0,0,0,0,0,0,0,0,0,0,0,0,0,0,0,"1990-506"
"2611",58,58,0,58,58,0,0,0,0,58,0,4,58,58,54,4,37,43,51,1,54,30,24,48,17,139,65,74,12,12,74,41,"1750-342"
"2612",0,0,0,0,0,0,0,0,0,0,0,0,0,0,0,0,0,0,0,0,0,0,0,0,0,0,0,0,0,0,0,0,"1990-523"
"2613",0,0,0,0,0,0,0,0,0,0,0,0,0,0,0,0,0,0,0,0,0,0,0,0,0,0,0,0,0,0,0,0,"1990-173"
"2614",49,5,43,48,12,37,3,43,2,0,1,1,366,365,285,80,9,7,119,147,285,212,73,169,58,600,252,348,62,42,322,174,"1750-200"
"2615",8,3,5,8,3,5,0,4,2,2,0,0,59,59,49,10,36,40,39,6,49,29,20,29,15,112,53,59,17,9,64,22,"1750-200"
"2616",41,0,41,39,0,41,0,41,0,0,0,1,446,446,348,98,8,4,132,189,348,269,79,181,71,675,286,389,73,46,343,213,"1750-161"
"2617",6,0,6,6,0,6,0,0,4,2,0,4,170,170,145,25,132,54,35,106,145,86,59,101,62,361,185,176,69,46,204,42,"1700-474"
"2618",11,0,11,11,0,11,0,0,0,11,0,9,101,101,74,27,23,2,2,68,74,31,43,67,45,244,120,124,67,37,121,19,"1800-412"
"2619",6,0,6,5,0,6,0,0,6,0,0,6,132,132,122,10,81,3,13,105,122,55,67,97,55,349,153,196,56,59,173,61,"1700-474"
"2620",23,20,3,23,23,0,18,1,4,0,0,5,51,51,36,15,2,1,3,31,36,23,13,21,11,84,39,45,12,11,48,13,"1750-025"
"2621",14,14,0,14,14,0,0,14,0,0,0,1,14,14,14,0,0,14,11,1,14,12,2,4,2,27,13,14,5,1,11,10,"1800-129"
"2622",23,23,0,23,23,0,0,20,1,0,2,1,24,24,19,5,9,6,11,6,19,7,12,21,8,64,29,35,8,3,35,18,"1700-046"
"2623",13,13,0,13,13,0,0,13,0,0,0,8,13,13,12,1,6,3,6,5,12,5,7,12,6,38,13,25,10,2,16,10,"1700-029"
"2624",8,0,8,7,0,8,0,0,8,0,0,0,173,173,148,25,67,57,116,17,148,102,46,92,40,317,144,173,43,24,140,110,"1600-641"
"2625",14,14,0,14,14,0,0,0,14,0,0,3,14,14,13,1,2,13,12,0,13,10,3,11,2,31,15,16,4,2,9,16,"1600-635"
"2626",9,0,9,8,0,9,0,0,9,0,0,1,137,137,121,16,29,83,98,15,121,79,42,73,41,263,125,138,28,33,155,47,"1885-092"
"2627",29,13,16,26,10,19,3,21,4,1,0,27,193,193,148,45,51,113,99,35,148,109,39,67,27,278,120,158,18,22,155,83,"1750-011"
"2628",11,0,11,9,0,11,0,11,0,0,0,7,218,218,165,53,91,37,114,41,165,96,69,108,64,387,159,228,51,50,177,109,"1849-028"
"2629",11,8,3,11,7,4,0,11,0,0,0,3,28,28,14,14,2,3,2,8,14,10,4,8,5,28,11,17,3,4,16,5,"1800-134"
"2630",17,0,17,14,0,17,0,0,0,17,0,0,277,277,227,50,195,227,163,56,227,108,119,170,121,616,297,319,133,81,368,34,"1990-099"
"2631",14,0,14,10,0,14,0,0,12,2,0,2,183,183,143,40,107,141,119,10,143,88,55,104,60,343,165,178,49,52,155,87,"1990-237"
"2632",8,0,8,7,0,8,0,0,0,8,0,0,208,208,141,67,123,141,81,48,141,80,61,101,65,371,189,182,96,28,225,22,"1990-088"
"2633",14,0,14,14,0,14,0,14,0,0,0,4,112,112,99,13,2,0,84,7,99,61,38,62,33,229,114,115,25,28,136,40,"1800-129"
"2634",3,0,3,3,0,3,0,3,0,0,0,2,75,75,61,14,9,1,43,11,61,31,30,38,24,158,63,95,23,18,93,24,"1800-119"
"2635",8,0,8,7,0,8,0,0,8,0,0,0,172,172,146,26,107,142,123,10,146,88,58,105,45,392,207,185,29,47,223,93,"1600-413"
"2636",21,0,21,18,0,21,0,0,6,12,3,7,618,618,489,129,470,474,367,96,489,266,223,341,203,1252,607,645,195,173,745,139,"1800-079"
"2637",6,0,6,5,0,6,0,6,0,0,0,0,71,71,63,8,1,0,33,28,63,36,27,50,26,171,80,91,25,23,98,25,"1800-129"
"2638",16,14,1,16,13,3,11,3,2,0,0,14,18,17,12,5,6,7,8,2,12,9,3,5,3,95,12,83,5,1,10,79,"1600-553"
"2639",12,0,12,9,0,12,0,1,11,0,0,4,228,228,162,66,26,129,120,23,162,107,55,104,51,360,153,207,44,42,192,82,"1749-009"
"2640",30,20,10,29,20,10,0,0,30,0,0,6,196,196,154,42,74,53,125,13,154,101,53,105,44,351,164,187,48,36,165,102,"1600-236"
"2641",12,0,12,11,0,12,0,0,10,2,0,1,226,226,201,25,173,198,171,20,201,92,109,169,103,559,261,298,72,105,290,92,"1600-577"
"2642",4,0,4,2,0,4,0,3,1,0,0,0,60,60,52,8,32,15,41,7,52,27,25,35,24,140,69,71,26,21,64,29,"1800-105"
"2643",7,2,5,7,2,5,0,0,0,7,0,0,30,30,28,2,24,28,26,1,28,15,13,22,12,80,44,36,11,18,37,14,"1990-033"
"2644",3,0,3,3,0,3,0,0,3,0,0,0,116,116,100,16,73,5,82,10,100,72,28,57,26,214,93,121,29,22,110,53,"1600-248"
"2645",19,17,1,19,15,4,0,19,0,0,0,0,23,22,15,7,7,11,14,1,15,7,8,12,8,49,25,24,8,8,24,9,"1800-129"
"2646",1,1,0,1,0,1,1,0,0,0,0,1,1,1,1,0,0,1,1,0,1,0,1,1,1,6,2,4,0,1,4,1,"1500-210"
"2647",7,0,7,5,0,7,0,0,0,7,0,0,82,82,64,18,58,64,50,10,64,32,32,51,29,173,94,79,27,24,92,30,"1990-083"
"2648",21,0,18,19,0,21,0,0,15,6,0,0,552,549,489,60,437,488,411,51,490,262,228,385,214,1455,613,842,204,187,758,306,"1600-648"
"2649",0,0,0,0,0,0,0,0,0,0,0,0,0,0,0,0,0,0,0,0,0,0,0,0,0,0,0,0,0,0,0,0,"1990-078"
"2650",7,0,7,7,0,7,0,0,5,2,0,0,131,131,119,12,102,114,92,18,119,64,55,80,54,311,148,163,51,53,172,35,"1600-577"
"2651",12,0,12,9,0,12,0,0,0,12,0,0,411,411,347,64,294,346,283,44,347,197,150,252,145,848,407,441,138,107,473,130,"1600-608"
"2652",3,0,3,3,0,3,0,3,0,0,0,0,123,123,106,17,96,2,81,14,106,81,25,54,16,202,88,114,15,12,107,68,"1800-328"
"2653",16,13,2,16,15,1,15,0,0,0,1,11,29,28,13,15,3,1,2,11,13,8,5,8,5,85,26,59,3,4,21,57,"1750-025"
"2654",32,32,0,32,32,0,0,0,0,32,0,1,32,32,29,3,21,23,27,1,29,19,10,20,7,67,30,37,8,2,33,24,"1750-342"
"2655",21,16,4,21,16,5,0,0,0,21,0,2,62,61,54,7,39,5,15,38,54,35,19,44,17,154,76,78,18,8,80,48,"1750-111"
"2656",0,0,0,0,0,0,0,0,0,0,0,0,0,0,0,0,0,0,0,0,0,0,0,0,0,0,0,0,0,0,0,0,"1750-025"
"2657",33,33,0,33,32,1,0,6,27,0,0,5,35,35,28,7,11,7,25,2,28,23,5,18,4,55,24,31,5,2,19,29,"1750-123"
"2658",9,0,9,9,0,9,0,0,9,0,0,7,109,109,102,7,10,4,3,91,102,49,53,85,55,302,148,154,81,43,146,32,"1750-123"
"2659",9,0,9,8,0,9,0,1,8,0,0,8,103,103,93,10,8,2,6,78,93,53,40,66,38,253,119,134,59,35,107,52,"1750-123"
"2660",2,0,2,2,0,2,0,2,0,0,0,0,146,146,128,18,31,5,33,91,128,73,55,101,53,340,158,182,66,34,154,86,"1750-025"
"2661",21,17,4,21,21,0,20,1,0,0,0,16,42,42,22,20,6,1,3,19,22,13,9,13,7,52,21,31,13,3,23,13,"1750-025"
"2662",40,16,24,39,19,21,0,29,11,0,0,28,164,164,124,40,7,23,32,85,124,80,44,84,42,298,138,160,43,40,153,62,"1750-123"
"2663",2,2,0,2,2,0,2,0,0,0,0,0,2,2,1,1,1,0,0,0,1,1,0,0,0,1,1,0,0,0,0,1,"1749-077"
"2664",6,2,4,6,0,6,0,0,0,6,0,0,34,34,23,11,11,23,18,3,23,14,9,20,9,61,36,25,13,5,34,9,"1600-516"
"2665",6,0,6,6,0,6,0,0,6,0,0,4,72,72,60,12,32,33,50,6,60,36,24,41,20,142,64,78,15,17,83,27,"1700-046"
"2666",5,0,5,5,0,5,0,1,4,0,0,5,64,64,58,6,8,3,50,5,58,32,26,45,20,153,74,79,24,13,86,30,"1700-046"
"2667",39,38,1,39,39,0,32,0,7,0,0,38,44,44,23,21,3,0,8,12,23,15,8,13,6,48,23,25,2,5,22,19,"1600-587"
"2668",11,0,11,10,0,11,0,6,5,0,0,5,162,162,137,25,30,94,112,9,137,80,57,107,43,354,169,185,40,42,177,95,"1700-046"
"2669",19,0,19,17,0,19,0,19,0,0,0,10,308,308,259,49,46,7,180,66,259,192,67,157,64,537,229,308,64,44,251,178,"1800-412"
"2670",4,0,4,3,0,4,0,0,0,4,0,1,101,101,86,15,77,86,61,13,86,51,35,57,36,203,104,99,43,18,122,20,"1990-427"
"2671",13,0,13,12,0,13,0,0,6,7,0,1,179,179,157,22,125,157,134,19,157,83,74,119,80,406,205,201,79,55,222,50,"1990-134"
"2672",9,5,4,7,5,4,1,7,1,0,0,7,27,27,22,5,2,4,3,18,22,15,7,20,8,55,25,30,10,5,25,15,"1750-032"
"2673",4,0,4,2,0,4,0,2,2,0,0,0,280,280,204,76,135,176,133,43,204,159,45,103,44,385,164,221,46,27,190,122,"1750-032"
"2674",0,0,0,0,0,0,0,0,0,0,0,0,0,0,0,0,0,0,0,0,0,0,0,0,0,0,0,0,0,0,0,0,"1700-474"
"2675",7,0,7,7,0,7,0,7,0,0,0,7,257,257,232,25,49,3,91,127,232,123,109,181,89,621,320,301,71,86,339,125,"1950-239"
"2676",2,0,0,2,2,0,2,0,0,0,0,0,2,0,0,0,0,0,0,0,0,0,0,0,0,204,145,59,13,3,142,46,"1700-250"
"2677",5,0,5,5,0,5,0,0,5,0,0,0,158,158,130,28,109,127,101,17,130,65,65,97,61,333,159,174,62,45,183,43,"1600-646"
"2678",7,0,7,5,0,7,0,0,6,1,0,2,148,148,130,18,93,128,108,13,130,73,57,100,62,336,158,178,50,56,195,35,"1750-200"
"2679",35,14,21,33,14,21,0,20,14,1,0,12,299,299,222,77,67,7,158,52,222,147,75,138,61,481,233,248,62,46,271,102,"1600-038"
"2680",0,0,0,0,0,0,0,0,0,0,0,0,0,0,0,0,0,0,0,0,0,0,0,0,0,0,0,0,0,0,0,0,"1750-025"
"2681",3,0,3,3,0,3,0,0,0,3,0,0,97,97,81,16,75,81,63,13,81,35,46,66,49,235,109,126,65,23,134,13,"1990-427"
"2682",5,0,5,4,0,5,0,0,0,5,0,0,50,50,46,4,39,46,35,6,46,23,23,40,21,136,69,67,26,21,61,28,"1990-134"
"2683",8,0,8,8,0,8,0,0,8,0,0,8,250,250,234,16,186,4,8,215,234,130,104,180,104,641,291,350,99,99,339,104,"1700-474"
"2684",24,0,24,24,0,24,0,0,0,24,0,22,256,256,195,61,59,4,2,184,195,66,129,190,128,685,331,354,174,136,313,62,"1800-412"
"2685",10,0,10,10,0,10,0,0,0,10,0,0,180,180,146,34,73,143,109,27,146,74,72,105,76,373,190,183,87,40,215,31,"1990-390"
"2686",19,0,19,16,0,19,0,19,0,0,0,18,214,214,166,48,2,0,67,85,166,115,51,99,44,371,151,220,47,42,183,99,"1750-161"
"2687",9,0,9,8,0,9,0,0,0,9,0,0,201,201,147,54,141,146,113,25,147,68,79,107,85,399,196,203,119,37,225,18,"1990-427"
"2688",15,0,15,14,0,15,0,15,0,0,0,14,209,209,153,56,15,0,68,76,153,112,41,81,31,308,143,165,25,32,163,88,"1750-161"
"2689",3,0,3,2,0,3,0,0,0,3,0,0,87,87,78,9,76,78,64,9,78,32,46,60,47,209,95,114,50,26,116,17,"1990-392"
"2690",9,0,9,8,0,9,0,0,9,0,0,0,147,147,115,32,94,115,88,22,115,71,44,73,46,274,137,137,42,49,145,38,"1990-403"
"2691",12,0,12,12,0,12,0,0,12,0,0,12,165,165,145,19,56,36,3,131,146,63,83,134,84,449,214,235,88,90,204,67,NA
"2692",39,23,16,36,17,22,3,0,2,21,13,0,162,162,111,51,90,109,80,21,111,62,49,81,51,282,137,145,57,33,175,17,"1600-038"
"2693",7,0,7,6,0,7,0,0,7,0,0,0,145,145,135,10,73,135,118,10,135,60,75,103,75,372,184,188,52,82,210,28,"1990-392"
"2694",5,0,5,5,0,5,0,5,0,0,0,0,182,182,145,37,136,139,124,9,145,108,37,88,29,297,132,165,36,16,147,98,"1750-200"
"2695",12,3,9,11,3,9,1,1,3,7,0,6,204,204,183,21,174,158,145,17,183,121,62,116,59,406,174,232,68,39,213,86,"1750-032"
"2696",23,0,23,22,0,23,0,23,0,0,0,3,318,318,259,59,40,4,162,82,259,186,73,169,60,568,271,297,53,44,288,183,"1800-412"
"2697",12,0,12,10,0,12,0,0,0,12,0,0,237,237,204,33,99,204,162,37,204,96,108,153,117,557,276,281,139,74,289,55,"1990-403"
"2698",6,0,6,5,0,6,0,6,0,0,0,0,119,119,98,21,72,94,84,8,98,76,22,55,19,193,84,109,24,12,68,89,"1750-200"
"2699",17,1,16,17,1,16,3,13,1,0,0,0,133,133,97,36,6,15,29,63,97,79,18,52,16,184,88,96,17,14,97,56,"1700-046"
"2700",29,29,0,29,28,1,0,23,4,1,1,27,30,30,28,2,12,10,18,5,28,17,11,26,8,79,38,41,5,13,32,29,"1700-079"
"2701",11,0,11,8,0,11,0,11,0,0,0,3,373,373,308,65,119,6,180,110,308,232,76,179,74,618,291,327,63,46,319,190,"1800-245"
"2702",2,0,1,2,0,2,0,0,1,1,0,0,45,44,35,9,19,35,31,1,35,23,12,27,8,157,103,54,7,13,107,30,"1900-271"
"2703",10,0,10,10,0,10,0,0,10,0,0,0,258,258,204,54,114,190,162,21,204,127,77,144,59,466,215,251,56,38,223,149,"1900-271"
"2704",8,0,8,6,0,8,0,0,8,0,0,8,397,397,296,101,224,288,211,59,296,214,82,169,87,604,285,319,82,57,369,96,"1750-170"
"2705",5,0,5,3,0,5,0,0,4,1,0,5,242,242,217,25,159,7,51,159,217,107,110,182,107,618,289,329,114,88,340,76,"1800-237"
"2706",3,0,3,2,0,3,0,0,3,0,0,3,117,117,110,7,79,4,31,77,110,54,56,85,51,304,140,164,49,48,154,53,"1800-237"
"2707",3,0,3,2,0,3,0,0,3,0,0,3,118,118,105,13,81,2,25,76,105,70,35,64,30,225,91,134,23,22,134,46,"1800-919"
"2708",2,0,2,2,0,2,0,0,2,0,0,0,109,109,97,12,92,2,82,11,97,62,35,66,21,218,99,119,15,22,120,61,"1800-233"
"2709",2,0,2,2,0,2,0,0,2,0,0,0,109,109,79,30,78,0,63,11,79,53,26,55,25,179,87,92,15,23,103,38,"1800-233"
"2710",22,19,3,22,19,3,19,3,0,0,0,16,38,38,27,11,2,3,3,23,27,21,6,13,5,49,23,26,6,2,30,11,"1350-097"
"2711",54,43,11,53,46,8,20,29,3,0,2,37,110,110,80,30,12,5,16,62,80,52,28,48,24,187,84,103,26,21,104,36,"1350-097"
"2712",10,0,10,10,10,0,4,6,0,0,0,3,57,57,42,15,2,0,18,24,42,23,19,30,19,108,51,57,17,14,55,22,"1350-097"
"2713",25,1,24,23,0,25,9,16,0,0,0,7,195,195,153,42,10,2,59,84,153,110,43,87,38,317,131,186,33,24,176,84,"1350-149"
"2714",4,0,4,4,0,4,0,4,0,0,0,0,24,24,16,8,0,0,12,3,16,11,5,9,3,33,16,17,2,2,23,6,"1700-344"
"2715",23,0,23,21,0,23,0,23,0,0,0,12,243,243,173,70,37,1,87,73,173,110,63,99,59,399,177,222,63,52,201,83,"1700-344"
"2716",14,0,14,14,0,14,0,14,0,0,0,0,159,159,127,32,53,88,107,10,127,87,40,73,34,274,124,150,35,27,121,91,"1700-232"
"2717",11,0,11,7,0,11,0,3,0,8,0,2,343,343,239,104,189,210,124,88,239,165,74,115,73,494,234,260,102,31,326,35,"1600-873"
"2718",7,0,7,7,0,7,1,6,0,0,0,1,101,101,83,18,2,1,33,45,83,57,26,49,24,174,71,103,26,13,91,44,"1350-149"
"2719",4,0,4,4,0,4,0,4,0,0,0,1,30,30,23,7,2,0,19,2,23,15,8,14,9,53,20,33,9,8,29,7,"1700-019"
"2720",10,0,9,10,0,10,0,7,3,0,0,0,299,298,226,72,69,219,171,30,226,157,69,141,55,503,234,269,56,36,255,156,"1900-410"
"2721",8,0,8,5,0,8,0,0,0,8,0,0,301,301,213,88,178,213,132,66,213,155,58,97,63,411,196,215,90,16,298,7,"1600-873"
"2722",6,0,6,5,0,6,0,0,6,0,0,6,162,162,128,34,106,121,91,24,128,85,43,78,36,280,133,147,31,28,163,58,"1750-170"
"2723",2,0,2,1,0,2,0,0,2,0,0,2,125,125,116,9,87,0,20,91,116,73,43,82,41,291,130,161,51,37,149,54,"1800-233"
"2724",5,0,5,5,0,5,0,0,5,0,0,5,200,200,187,13,128,3,31,150,187,97,90,155,95,543,248,295,84,86,287,86,"1800-237"
"2725",25,0,24,21,0,25,0,24,0,0,1,21,267,266,219,47,34,16,58,150,219,150,69,122,66,481,212,269,71,42,231,137,"1700-344"
"2726",14,3,11,14,3,11,5,8,1,0,0,1,67,67,42,25,1,7,15,21,42,35,7,15,7,77,33,44,4,11,37,25,"1649-003"
"2727",4,0,4,4,0,4,0,0,0,1,3,2,96,96,71,25,67,71,42,24,71,43,28,46,27,162,78,84,26,18,102,16,"1900-410"
"2728",9,0,9,7,0,9,0,9,0,0,0,6,163,163,114,49,39,2,24,76,114,99,15,47,18,189,75,114,22,12,102,53,"1600-311"
"2729",16,0,16,13,0,16,5,8,1,0,2,8,186,186,112,74,45,41,56,47,112,83,29,51,29,227,103,124,32,25,134,36,"1600-035"
"2730",20,17,3,20,20,0,0,20,0,0,0,13,33,33,23,10,5,7,14,4,23,15,8,17,6,55,26,29,4,5,28,18,"1800-002"
"2731",0,0,0,0,0,0,0,0,0,0,0,0,0,0,0,0,0,0,0,0,0,0,0,0,0,0,0,0,0,0,0,0,"1800-177"
"2732",10,2,8,7,2,8,10,0,0,0,0,1,36,36,21,15,0,1,4,16,21,18,3,7,2,35,13,22,0,6,17,12,"1100-331"
"2733",19,0,19,19,1,18,13,4,0,1,1,0,135,135,106,29,10,13,47,49,106,63,43,68,39,247,105,142,48,23,130,46,"1350-311"
"2734",0,0,0,0,0,0,0,0,0,0,0,0,0,0,0,0,0,0,0,0,0,0,0,0,0,0,0,0,0,0,0,0,"1800-192"
"2735",6,2,4,6,2,4,2,3,1,0,0,0,88,88,53,35,14,11,30,18,53,47,6,27,5,90,41,49,3,4,53,30,"1800-046"
"2736",37,31,6,35,29,8,32,5,0,0,0,27,62,62,36,26,6,1,13,20,36,32,4,13,4,55,25,30,4,2,28,21,"1300-481"
"2737",19,0,19,15,0,19,0,0,19,0,0,0,370,370,282,88,139,173,105,155,282,196,86,176,82,650,292,358,89,71,412,78,"1600-003"
"2738",35,1,34,23,0,35,7,22,5,1,0,4,418,418,305,113,74,91,172,100,305,201,104,178,93,694,307,387,114,60,360,160,"1000"
"2739",10,0,10,10,0,10,0,0,0,10,0,7,210,210,194,16,77,7,8,174,194,98,96,149,93,532,254,278,79,97,263,93,"1750-342"
"2740",6,0,6,6,0,6,0,0,6,0,0,4,65,65,61,4,16,5,7,52,61,34,27,44,18,150,72,78,17,12,78,43,"1600-647"
"2741",12,1,11,10,1,11,6,4,1,1,0,4,87,87,58,29,6,8,28,26,58,42,16,32,18,126,58,68,22,12,72,20,"1300-320"
"2742",14,7,7,14,8,6,9,1,4,0,0,3,89,89,80,9,46,49,8,70,80,55,25,57,25,184,86,98,22,25,95,42,"1350"
"2743",43,24,19,41,26,17,40,2,0,1,0,30,118,118,69,49,7,1,29,37,69,45,24,37,19,143,71,72,16,14,75,38,"1100-359"
"2744",10,0,9,4,1,9,4,4,0,1,1,4,79,78,48,30,18,12,13,28,48,28,20,28,17,130,57,73,16,11,63,40,"1050-100"
"2745",25,2,23,24,4,21,20,4,0,1,0,4,127,127,90,37,5,1,26,54,90,66,24,47,21,187,94,93,21,14,122,30,"1170"
"2746",22,5,17,20,5,17,8,10,1,2,1,2,114,114,85,29,7,1,47,31,85,58,27,46,26,185,79,106,36,12,95,42,"1350-322"
"2747",0,0,0,0,0,0,0,0,0,0,0,0,0,0,0,0,0,0,0,0,0,0,0,0,0,0,0,0,0,0,0,0,"1070-044"
"2748",16,2,14,14,1,15,4,12,0,0,0,9,97,97,66,31,15,16,21,40,66,52,14,29,11,125,60,65,14,8,58,45,"1200-747"
"2749",2,0,2,0,0,2,0,0,0,2,0,0,30,30,17,13,12,17,8,9,17,13,4,9,6,35,19,16,6,4,25,0,"1200-387"
"2750",3,0,3,1,0,3,0,0,2,1,0,0,113,113,84,29,69,84,76,5,84,44,40,65,35,228,102,126,33,33,120,42,"1990-080"
"2751",25,6,18,22,5,20,8,13,3,1,0,11,94,93,64,29,6,14,28,34,64,41,23,39,22,168,54,114,28,14,78,48,"1200-702"
"2752",100,45,55,89,35,65,14,61,21,3,1,23,315,315,209,106,26,6,75,114,209,163,46,105,41,401,186,215,37,31,218,115,"1300-300"
"2753",64,14,49,47,16,48,29,26,4,5,0,51,476,475,369,106,48,85,148,196,369,250,119,211,103,849,404,445,97,88,486,178,"1170-220"
"2754",4,0,4,3,0,4,0,4,0,0,0,0,145,145,112,33,9,2,41,59,112,100,12,35,14,165,65,100,12,6,94,53,"1700-350"
"2755",28,0,28,27,28,0,0,28,0,0,0,1,111,111,88,23,9,2,50,34,88,49,39,75,19,233,115,118,20,19,116,78,"1950-449"
"2756",25,13,12,19,12,13,25,0,0,0,0,9,69,69,42,27,5,0,7,33,42,36,6,25,10,84,44,40,7,9,62,6,"1100-474"
"2757",15,4,11,14,3,12,11,3,1,0,0,3,65,65,31,34,3,4,12,19,31,24,7,16,9,56,25,31,8,4,27,17,"1150-291"
"2758",10,0,10,7,0,10,6,2,0,1,1,5,95,95,74,21,22,12,46,23,74,44,30,53,27,182,90,92,33,14,95,40,"1070-015"
"2759",13,1,12,7,1,12,8,1,0,0,4,3,63,63,29,34,5,10,20,7,29,20,9,14,6,59,34,25,7,4,36,12,"1200-014"
"2760",6,0,6,6,0,6,0,6,0,0,0,0,212,212,195,17,56,3,65,124,195,130,65,126,53,427,198,229,48,43,210,126,"1800-292"
"2761",12,6,6,12,7,5,7,0,0,0,5,5,51,51,19,32,15,13,10,7,19,12,7,13,6,43,20,23,8,3,23,9,"1950-408"
"2762",10,0,9,9,0,10,4,6,0,0,0,3,176,175,143,32,9,1,56,80,143,86,57,81,51,339,154,185,66,34,182,57,"1700-112"
"2763",39,39,0,39,34,5,21,17,1,0,0,7,39,39,31,8,11,26,29,1,31,16,15,29,9,86,38,48,10,5,45,26,"1800-281"
"2764",0,0,0,0,0,0,0,0,0,0,0,0,0,0,0,0,0,0,0,0,0,0,0,0,0,0,0,0,0,0,0,0,"1100"
"2765",7,0,7,7,0,7,0,7,0,0,0,0,98,98,90,8,48,2,67,21,90,53,37,71,27,220,91,129,29,17,90,84,"1950-211"
"2766",8,2,6,8,1,7,2,5,0,0,1,6,80,80,57,23,7,1,19,37,57,43,14,30,15,106,51,55,13,6,62,25,"1349-049"
"2767",16,0,16,15,0,16,0,0,16,0,0,10,213,213,191,22,56,3,29,159,191,115,76,145,72,473,207,266,58,60,244,111,"1600-647"
"2768",42,40,1,42,8,34,0,3,36,1,2,4,45,44,41,3,6,37,34,4,41,27,14,30,12,99,47,52,8,6,58,27,"1849-029"
"2769",10,10,0,10,9,1,9,0,1,0,0,4,13,13,8,5,3,4,4,3,8,7,1,2,0,11,3,8,0,0,6,5,"1300-996"
"2770",13,3,10,12,3,10,7,4,0,2,0,6,65,65,49,16,10,17,28,17,49,37,12,24,9,99,45,54,11,8,59,21,"1250-259"
"2771",2,0,2,0,0,2,2,0,0,0,0,1,8,8,6,2,0,0,4,1,6,5,1,2,1,12,5,7,1,2,8,1,"1100-062"
"2772",26,4,22,25,3,23,16,5,1,2,2,8,148,148,110,38,21,21,42,59,110,76,34,57,25,243,126,117,29,19,149,46,"1150-192"
"2773",5,0,5,4,0,5,0,0,0,5,0,5,137,137,117,20,86,117,103,6,117,65,52,86,51,290,122,168,45,39,149,57,"1750-170"
"2774",0,0,0,0,0,0,0,0,0,0,0,0,0,0,0,0,0,0,0,0,0,0,0,0,0,0,0,0,0,0,0,0,"1000-178"
"2775",16,0,16,12,2,14,0,1,13,2,0,0,532,532,446,86,342,337,205,207,446,325,121,232,124,876,406,470,104,86,544,142,"1170-139"
"2776",8,8,0,8,8,0,0,0,8,0,0,2,8,8,8,0,3,6,7,0,8,2,6,9,5,24,9,15,3,4,8,9,"1750-342"
"2777",5,2,3,5,2,3,0,0,5,0,0,4,29,29,22,7,8,1,1,18,22,12,10,18,11,65,30,35,10,12,33,10,"1300-325"
"2778",22,1,20,18,0,22,5,17,0,0,0,1,217,216,181,35,40,33,102,61,181,115,66,102,60,425,187,238,59,65,195,106,"1250-212"
"2779",4,4,0,4,0,4,0,2,2,0,0,0,4,4,3,1,1,3,3,0,3,2,1,3,0,7,3,4,0,0,2,5,"1400-318"
"2780",19,0,19,18,0,19,0,19,0,0,0,18,354,354,290,64,28,2,135,131,290,219,71,149,68,570,234,336,87,42,261,180,"1350-075"
"2781",23,0,21,13,0,23,0,23,0,0,0,23,256,254,198,56,19,16,110,69,198,99,99,146,80,558,273,285,74,97,271,116,"1000-167"
"2782",32,3,29,28,1,31,16,16,0,0,0,5,202,202,137,65,4,7,71,56,137,110,27,64,25,261,125,136,23,16,180,42,"1170-185"
"2783",10,0,10,10,0,10,0,0,10,0,0,0,115,115,95,20,92,94,80,10,95,46,49,79,51,256,131,125,48,34,151,23,"1990-197"
"2784",1,0,1,0,0,1,0,0,1,0,0,0,3,3,1,2,1,0,1,0,1,1,0,1,0,2,1,1,0,0,0,2,"1100-486"
"2785",139,95,44,136,91,48,0,138,0,1,0,47,540,540,412,128,66,24,281,95,412,300,112,233,93,821,367,454,85,59,434,243,"1800-210"
"2786",19,0,19,16,0,19,0,0,19,0,0,1,166,166,145,21,133,144,115,22,145,86,59,95,60,335,166,169,47,46,202,40,"1990-370"
"2787",46,4,41,30,0,46,1,42,0,3,0,1,305,304,224,80,43,6,89,116,225,156,69,117,59,477,207,270,66,51,256,104,"1070-234"
"2788",40,1,39,36,0,40,19,21,0,0,0,4,305,305,225,80,26,5,113,90,225,155,70,122,61,479,207,272,61,53,244,121,"1070-230"
"2789",43,35,7,43,27,16,1,26,6,1,9,9,180,179,133,46,105,128,98,19,133,90,43,74,36,324,138,186,45,22,166,91,"1700-198"
"2790",6,1,4,3,0,6,6,0,0,0,0,1,27,27,8,19,0,0,1,5,8,3,5,9,4,29,20,9,6,3,18,2,"1100-232"
"2791",0,0,0,0,0,0,0,0,0,0,0,0,0,0,0,0,0,0,0,0,0,0,0,0,0,0,0,0,0,0,0,0,"1600-416"
"2792",15,1,14,13,0,15,14,1,0,0,0,2,58,58,25,33,0,0,7,15,25,18,7,10,3,52,27,25,2,6,30,14,"1200-145"
"2793",13,1,12,11,1,12,0,13,0,0,0,0,246,246,196,50,4,8,125,62,196,139,57,122,51,421,196,225,48,37,210,126,"1950-053"
"2794",14,4,10,13,3,11,9,3,1,0,1,8,98,98,62,36,14,17,40,19,62,34,28,35,22,157,72,85,32,15,87,23,"1051-802"
"2795",9,0,9,9,1,8,0,2,1,6,0,2,99,99,77,22,40,70,46,24,77,56,21,41,20,150,68,82,20,12,106,12,"1300-096"
"2796",28,1,27,22,2,26,6,21,1,0,0,19,298,298,205,93,32,11,92,97,205,156,49,113,47,404,182,222,45,26,216,117,"1300-245"
"2797",10,0,10,8,0,10,0,10,0,0,0,1,132,132,100,32,4,8,69,24,100,66,34,64,28,224,103,121,25,19,122,58,"1800-131"
"2798",24,0,24,21,0,24,0,0,24,0,0,9,334,334,264,70,84,17,182,55,264,179,85,157,96,572,277,295,84,63,335,90,"1600-615"
"2799",23,2,20,15,2,21,8,13,2,0,0,7,212,211,166,45,50,19,67,87,166,113,53,96,44,393,186,207,50,44,213,86,"1000-149"
"2800",10,0,10,8,0,10,0,10,0,0,0,3,94,94,80,14,3,0,55,21,80,43,37,54,36,203,91,112,38,29,102,34,"1300-375"
"2801",9,0,9,9,0,9,0,0,0,9,0,0,272,272,224,48,212,222,188,22,224,116,108,171,97,593,298,295,99,80,330,84,"1600-648"
"2802",49,26,22,49,30,19,0,47,2,0,0,37,181,181,151,29,11,9,23,120,152,91,61,109,55,376,167,209,75,44,175,82,"1750-462"
"2803",17,3,14,15,2,15,6,7,3,1,0,4,105,105,77,28,4,24,33,35,77,45,32,45,24,194,91,103,27,18,107,42,"1000-032"
"2804",51,2,49,48,3,48,0,48,2,1,0,34,441,441,333,108,38,35,141,159,333,255,78,171,64,672,286,386,62,43,385,182,"1900-221"
"2805",15,15,0,15,2,13,0,14,0,0,1,0,15,15,12,3,3,5,11,1,12,5,7,11,7,34,17,17,3,8,17,6,"1900-311"
"2806",31,0,30,20,0,31,1,30,0,0,0,13,307,306,243,63,22,65,127,95,243,164,79,129,78,545,260,285,92,62,286,105,"1700-159"
"2807",6,0,6,4,0,6,0,1,5,0,0,4,129,129,114,15,48,5,24,48,114,54,60,101,49,333,165,168,60,35,181,57,"1900-916"
"2808",23,2,20,14,2,21,16,2,0,3,2,16,118,118,72,46,7,8,36,30,72,57,15,33,12,135,64,71,8,17,79,31,"1200-311"
"2809",13,0,13,9,0,13,11,1,0,0,1,3,50,50,32,18,0,0,2,28,32,25,7,11,5,55,23,32,5,5,31,14,"1200-651"
"2810",1,0,1,1,0,1,1,0,0,0,0,0,11,11,3,8,3,3,1,2,3,3,0,1,0,4,3,1,0,0,1,3,"1250-004"
"2811",11,0,11,8,0,11,0,0,10,0,1,0,246,246,202,44,130,195,167,15,202,127,75,147,54,485,240,245,46,58,237,144,"1500-359"
"2812",7,1,5,2,0,7,7,0,0,0,0,3,20,20,12,8,3,0,4,8,12,9,3,6,1,25,13,12,0,2,16,7,"1200-994"
"2813",11,2,9,5,2,9,11,0,0,0,0,5,43,43,22,21,2,1,5,16,22,15,7,11,5,47,23,24,4,4,34,5,"1200-293"
"2814",12,0,12,10,0,12,0,0,0,12,0,0,375,375,320,55,235,317,225,73,320,203,117,174,116,693,363,330,136,50,469,38,"1700-474"
"2815",11,7,2,11,5,6,0,10,0,0,1,7,69,67,49,18,12,12,27,14,49,35,14,28,14,150,51,99,8,19,54,69,"1700-029"
"2816",14,0,14,8,0,14,14,0,0,0,0,2,84,84,41,43,8,7,11,28,41,37,4,18,4,69,34,35,3,4,39,23,"1200-335"
"2817",16,16,0,16,15,1,16,0,0,0,0,1,18,18,14,4,1,0,10,3,14,13,1,2,1,17,6,11,0,1,7,9,"1000-197"
"2818",25,10,15,13,8,17,24,0,0,0,1,8,110,110,61,49,3,0,21,34,61,53,8,21,8,101,56,45,7,7,62,25,"1100-376"
"2819",14,2,12,14,0,14,0,14,0,0,0,0,76,76,54,22,1,1,37,10,54,36,18,31,15,112,45,67,19,5,56,32,"1700-331"
"2820",17,0,17,17,0,17,0,17,0,0,0,0,107,107,91,16,1,9,56,28,91,61,30,60,29,199,92,107,25,21,102,51,"1700-996"
"2821",28,25,3,28,27,1,2,20,6,0,0,18,36,36,18,18,5,1,2,13,18,16,2,9,3,33,12,21,2,5,23,3,"1070"
"2822",15,10,3,15,12,3,2,12,1,0,0,0,31,29,18,11,2,4,2,4,18,12,6,10,1,77,18,59,8,6,32,31,"1500-467"
